volume_id,company_id,date,buy_volume,sell_volume,net_volume
150543,8800,2023-11-18,6058,51587,-45529
291909,1497,2022-07-23,22053,96552,-74499
195134,6150,2022-10-09,38039,77192,-39153
798654,3116,2024-09-01,35503,42837,-7334
721632,4127,2022-09-27,65647,86984,-21337
793888,1902,2023-12-16,47486,79240,-31754
572231,7771,2022-09-13,47737,40729,7008
380994,5986,2022-07-20,41709,18954,22755
676069,1176,2023-10-08,77569,30689,46880
250385,8037,2024-02-06,26908,88287,-61379
254356,8647,2024-09-24,90218,38027,52191
154481,8442,2023-02-09,87889,2315,85574
568608,5941,2023-05-17,63880,77374,-13494
823107,9817,2024-09-24,87467,58313,29154
731050,4086,2023-06-27,45036,91004,-45968
318576,1479,2022-06-28,49047,55602,-6555
465980,9023,2024-08-16,38820,61479,-22659
692777,7209,2023-07-10,49092,86698,-37606
792847,1351,2021-10-07,77990,6875,71115
118978,1063,2023-11-08,96176,35655,60521
788273,6821,2023-05-24,41646,8048,33598
391829,4574,2023-10-08,4432,81542,-77110
102945,4703,2023-05-16,14080,3120,10960
892322,1479,2023-10-13,59962,61365,-1403
120546,4896,2024-04-02,3989,60824,-56835
166680,8999,2022-03-21,1963,70014,-68051
829380,4241,2022-06-03,42130,72802,-30672
427603,9901,2024-05-27,48703,94428,-45725
805970,1396,2023-11-19,18737,85597,-66860
578157,7011,2024-02-21,63944,83427,-19483
872051,8350,2023-11-16,57066,80551,-23485
222734,5322,2023-01-15,83954,34656,49298
335626,1869,2022-01-16,33719,53602,-19883
858452,5988,2023-04-13,13782,28317,-14535
583114,5330,2022-07-27,95688,27460,68228
575706,7120,2023-01-13,75727,8996,66731
791556,9943,2023-04-06,33335,44629,-11294
279073,5770,2021-10-28,48630,24307,24323
980764,1947,2022-05-10,47910,80024,-32114
390132,5965,2023-01-05,66973,30041,36932
859762,4002,2022-09-01,11072,77870,-66798
472001,9082,2023-05-08,49430,68068,-18638
569890,5965,2023-10-12,16546,49052,-32506
774942,1651,2022-10-20,37684,15914,21770
301632,8691,2024-01-04,90712,28788,61924
534694,1376,2022-11-17,68583,47385,21198
452959,7209,2023-12-22,40422,93474,-53052
681304,2192,2023-02-20,62208,5027,57181
690768,7818,2024-02-13,91466,26099,65367
274913,5385,2022-08-21,20280,31246,-10966
406544,5974,2023-11-06,43967,4833,39134
604012,2085,2024-07-16,50937,94629,-43692
641690,5171,2024-04-28,1303,53348,-52045
417212,4363,2022-06-09,65575,5516,60059
286630,5525,2023-02-20,81483,10004,71479
636730,6563,2024-09-01,18413,89549,-71136
676325,7470,2022-10-19,1847,98679,-96832
702541,7036,2023-04-09,76817,23508,53309
579237,9132,2022-08-14,49386,43636,5750
933707,7204,2023-06-03,63427,1616,61811
867023,9116,2024-07-18,43014,71799,-28785
740525,4968,2022-05-06,56970,91905,-34935
507423,9060,2024-06-20,65226,5309,59917
676254,4798,2024-01-13,98062,49815,48247
894013,4735,2024-08-09,70178,95193,-25015
788377,4539,2023-10-06,58100,14002,44098
603520,3267,2023-01-02,5209,18767,-13558
562906,7072,2024-03-26,84150,50166,33984
125415,3108,2024-04-08,98752,29293,69459
742783,2217,2022-11-03,86674,18299,68375
705156,8800,2023-03-19,84989,71019,13970
772770,6324,2021-10-16,94267,35498,58769
516796,8037,2023-02-25,25565,13700,11865
994788,8576,2022-05-09,59993,43590,16403
269827,3040,2022-08-04,63527,13204,50323
825593,9903,2023-08-16,5370,52314,-46944
801079,1386,2022-05-12,79572,77934,1638
936536,4369,2022-08-03,79534,73361,6173
180979,7330,2022-04-23,64163,46447,17716
267933,9478,2022-01-06,83324,30985,52339
841391,7898,2024-01-30,79218,99026,-19808
820912,9596,2024-08-03,39088,35271,3817
321188,7395,2024-06-17,96603,25000,71603
553113,3292,2023-08-09,20836,8278,12558
608141,4726,2022-02-14,39156,8581,30575
602181,7256,2022-11-24,85845,88253,-2408
697923,6150,2022-12-25,61912,33314,28598
593856,1008,2022-07-07,63462,28372,35090
541252,9719,2021-12-01,34401,98278,-63877
868640,1473,2024-02-17,96894,79729,17165
639625,5319,2024-05-14,82892,18202,64690
525616,1479,2024-04-01,19528,55635,-36107
492324,7911,2023-04-01,41635,72569,-30934
971077,7732,2024-06-29,21561,81623,-60062
523523,4726,2021-12-06,27296,78932,-51636
925987,9951,2024-07-31,47339,75001,-27662
697915,1286,2023-07-16,40863,90588,-49725
476956,2355,2024-09-17,37841,20370,17471
549369,6361,2024-09-06,95894,50773,45121
749583,8051,2024-03-08,41944,23252,18692
868948,8442,2023-06-26,50185,21474,28711
148458,9901,2023-10-02,21054,8528,12526
128681,7470,2022-11-18,15929,16331,-402
923610,5171,2024-02-13,40525,63786,-23261
623671,2991,2023-08-22,14672,68414,-53742
823688,2217,2022-12-02,48488,86682,-38194
892131,1882,2023-10-29,91787,65857,25930
782321,1176,2023-10-08,33833,15699,18134
420143,1082,2022-01-22,53934,43454,10480
705901,7011,2023-06-19,68427,37728,30699
687693,5464,2023-01-29,5707,63065,-57358
532009,3572,2023-09-09,68186,21400,46786
429122,5770,2024-07-11,58427,36305,22122
851046,6016,2022-07-18,43068,4902,38166
808232,8970,2022-11-19,88625,44397,44228
151125,3108,2022-08-20,11436,74620,-63184
858288,4208,2024-06-04,34366,82559,-48193
139896,5632,2023-07-02,24991,55345,-30354
265754,3116,2024-06-14,46535,9565,36970
661635,9055,2023-02-17,9247,32979,-23732
629933,1497,2021-10-12,89209,50168,39041
839824,9441,2023-05-24,35569,95011,-59442
980074,7223,2023-03-29,4980,83525,-78545
648589,4363,2024-04-08,39290,20281,19009
337520,8773,2023-07-27,42839,46394,-3555
343875,6880,2023-06-21,8874,41635,-32761
296570,7771,2021-12-06,62758,45751,17007
837145,2611,2022-04-10,12604,51449,-38845
273309,7225,2024-03-25,21807,54416,-32609
796485,7152,2023-04-25,29903,23937,5966
828148,5988,2023-03-10,21715,37249,-15534
623279,1768,2022-04-18,54862,47150,7712
174040,5575,2021-10-09,61533,43418,18115
286574,6541,2023-06-01,24216,61565,-37349
646856,3559,2023-05-16,55467,17339,38128
507869,4574,2024-05-23,12347,97357,-85010
681585,5249,2023-12-20,77238,29276,47962
758607,2355,2024-04-22,59421,8402,51019
495183,2398,2024-05-01,55853,23563,32290
153906,2074,2022-05-15,90705,53087,37618
282826,7209,2023-09-09,15183,54830,-39647
583351,5889,2022-08-11,67625,39798,27827
884769,9865,2023-11-10,87009,20903,66106
970483,4689,2022-07-24,38580,60128,-21548
675880,2693,2024-04-12,82503,58925,23578
603318,5071,2023-11-07,63065,97666,-34601
628468,9004,2024-08-18,93858,69377,24481
508370,1479,2022-06-02,79443,44198,35245
705176,9128,2023-12-06,31151,79313,-48162
467837,2074,2023-05-01,58679,89325,-30646
357235,8130,2022-03-26,83393,63136,20257
917913,7635,2024-05-13,22725,48794,-26069
782034,6332,2022-08-15,32502,60640,-28138
212493,4208,2021-10-02,21138,93694,-72556
606629,7415,2023-06-13,23677,60441,-36764
934387,6324,2024-08-23,56591,8826,47765
490676,1566,2022-11-27,34110,59632,-25522
658602,5817,2023-11-25,76396,53829,22567
251191,9713,2024-07-31,73089,90076,-16987
106710,3776,2022-01-11,75187,97445,-22258
474774,9865,2023-10-10,6977,68528,-61551
772469,6937,2022-03-08,53901,87015,-33114
142011,6347,2023-05-28,18427,42282,-23855
637452,1302,2021-11-04,6446,54008,-47562
116710,5592,2022-09-27,89341,96687,-7346
149352,5459,2023-12-04,21813,46147,-24334
942230,4208,2024-07-23,38879,83797,-44918
769759,3714,2022-04-09,80778,94267,-13489
388515,2857,2024-07-06,56794,85163,-28369
326889,1882,2023-07-04,25625,20438,5187
935860,1479,2022-12-21,50327,76471,-26144
332195,8030,2022-12-04,78135,20566,57569
740418,3267,2024-09-21,79976,68693,11283
668256,5941,2024-03-23,2270,22883,-20613
210297,7359,2023-02-06,85372,71248,14124
844498,7223,2022-01-05,78733,93239,-14506
650057,9841,2022-12-07,49443,93860,-44417
897066,1473,2024-06-23,66891,55915,10976
977092,9694,2023-03-02,78503,99585,-21082
154931,9951,2023-03-10,40217,82845,-42628
492437,8218,2024-07-18,12683,45249,-32566
729250,9535,2022-04-24,37403,2337,35066
261812,3292,2021-11-28,30135,64275,-34140
670795,5071,2022-05-31,14277,11034,3243
426527,8576,2022-08-12,50771,36939,13832
483893,1016,2024-09-22,23281,68085,-44804
256823,9817,2023-05-29,74501,50290,24211
461648,7401,2023-08-18,74285,31338,42947
741060,1517,2023-05-10,42880,43433,-553
952967,1497,2021-10-15,85810,58829,26981
640262,5705,2023-06-10,3866,23169,-19303
933677,6290,2021-11-06,25437,72514,-47077
912276,5749,2022-09-08,27645,48330,-20685
224707,9694,2021-12-09,61901,23527,38374
594427,4261,2024-03-04,72863,97866,-25003
748242,1537,2022-07-24,26862,1839,25023
635036,1250,2022-12-09,30143,46161,-16018
695138,2623,2022-11-21,78893,84608,-5715
887160,5705,2024-03-21,69359,95792,-26433
966339,5459,2022-07-12,42210,93845,-51635
579372,2251,2023-07-17,60751,51364,9387
156011,1785,2022-05-25,4907,77823,-72916
171834,5986,2021-10-27,73885,82142,-8257
621460,5158,2022-09-23,9983,12009,-2026
489010,8976,2023-01-10,87829,59836,27993
279710,1176,2022-09-08,54575,22843,31732
746077,1807,2023-06-11,80738,20165,60573
893267,9535,2024-04-18,94005,93141,864
460986,9207,2022-12-15,20357,39174,-18817
196252,6726,2022-05-25,56583,29105,27478
577521,1118,2022-02-21,20582,30434,-9852
518635,1208,2022-05-02,74939,78843,-3904
492986,2711,2024-07-23,1637,56007,-54370
134425,4735,2022-08-14,18394,47666,-29272
136887,7771,2022-03-28,46378,82786,-36408
850188,2937,2023-06-08,49637,1439,48198
113713,8800,2021-10-26,3775,71461,-67686
648267,2902,2022-07-03,61977,62733,-756
258841,8800,2023-04-09,9716,61064,-51348
792072,9322,2022-08-26,36036,61608,-25572
560951,6083,2024-01-13,93327,47246,46081
821847,9901,2022-12-23,65378,69713,-4335
824597,6563,2022-01-06,92255,78192,14063
686920,6663,2022-12-03,96868,43561,53307
932597,2672,2022-12-02,92591,53784,38807
315757,3292,2022-08-01,26729,55848,-29119
813792,4237,2022-05-30,11814,85698,-73884
289019,8011,2023-04-02,24145,12822,11323
333692,3832,2024-07-24,37727,73442,-35715
358195,4663,2024-02-16,96089,57449,38640
326770,8351,2023-12-12,18244,63994,-45750
443290,7204,2024-05-09,13793,84271,-70478
247842,3776,2022-08-14,85241,32421,52820
393407,2476,2024-05-03,24243,11887,12356
772923,5916,2024-03-17,72685,56575,16110
793546,5240,2022-07-24,7185,71165,-63980
375456,7166,2023-02-02,9015,62325,-53310
274812,9672,2024-05-24,72569,90916,-18347
697158,6685,2023-07-29,55877,11227,44650
111930,1948,2024-04-05,4049,9349,-5300
374677,9010,2024-04-03,23178,49049,-25871
720841,5814,2023-09-16,12384,42551,-30167
698205,3292,2022-07-12,93487,71948,21539
141135,9943,2024-07-07,69433,42864,26569
276219,9441,2024-07-13,15509,7752,7757
339146,8725,2023-12-07,36307,26583,9724
940402,3267,2022-01-07,27499,94651,-67152
655663,4947,2022-01-20,7881,47965,-40084
696541,4243,2023-06-19,75754,79172,-3418
212876,8968,2024-07-14,60774,7804,52970
326480,9223,2023-05-03,29059,15453,13606
166994,6690,2024-06-16,11234,90098,-78864
479989,2821,2022-06-09,86048,19089,66959
643418,2991,2021-12-23,33927,50808,-16881
755886,2045,2024-03-30,25749,63308,-37559
708799,9981,2023-10-15,39759,59952,-20193
469230,6371,2023-06-06,11052,61892,-50840
711989,8740,2022-12-15,33902,54464,-20562
958121,6280,2022-01-30,51471,1257,50214
862120,3721,2022-10-13,33430,59752,-26322
669572,7152,2024-03-24,79912,88828,-8916
940233,4595,2024-03-17,92984,53579,39405
168650,7264,2023-11-02,65767,71131,-5364
194999,4399,2024-09-08,30200,52567,-22367
657599,2623,2024-03-07,54249,17715,36534
169084,1768,2022-02-28,36728,7612,29116
609608,7152,2023-12-31,33936,44697,-10761
207324,9596,2023-06-04,43503,86169,-42666
299014,1227,2022-05-22,40188,93178,-52990
438204,7403,2023-11-05,38167,39126,-959
387230,4367,2021-09-30,62091,95631,-33540
246758,9865,2021-10-21,33022,8143,24879
521124,3572,2024-04-14,11696,69815,-58119
523839,2011,2021-10-28,24736,20959,3777
170029,7501,2023-02-26,51576,15260,36316
198870,1977,2023-04-08,89914,24146,65768
957012,9951,2023-05-23,18717,17215,1502
121667,2011,2023-03-11,70174,91632,-21458
543819,6016,2024-04-22,27197,52430,-25233
964049,1496,2021-12-12,49620,95741,-46121
359014,1807,2023-02-22,51562,23106,28456
960221,5157,2024-05-28,14540,60751,-46211
819221,1103,2023-06-04,46573,34777,11796
128090,6965,2022-06-21,86586,4772,81814
990940,2013,2024-02-25,26193,43966,-17773
247813,8702,2024-05-14,68080,60457,7623
241050,8011,2023-04-05,6474,38091,-31617
457161,6324,2022-12-28,74137,13590,60547
122449,1767,2022-10-19,35296,3207,32089
213853,6023,2022-01-16,19663,67571,-47908
375631,9010,2022-06-15,61473,93138,-31665
553183,9317,2024-04-28,69066,7860,61206
454435,1882,2023-05-13,32640,66070,-33430
618801,2821,2022-02-16,35292,39035,-3743
723604,5957,2022-04-23,12472,82572,-70100
107989,3450,2023-11-14,93322,6442,86880
369044,1496,2022-10-08,31038,69367,-38329
104989,1082,2021-11-18,78091,87930,-9839
806244,7662,2024-02-17,7493,8227,-734
629845,3572,2023-04-25,93791,95181,-1390
513441,6290,2024-06-30,49948,7183,42765
595845,4896,2024-06-11,16306,75999,-59693
983538,4900,2021-09-29,88414,61905,26509
844638,8483,2024-07-30,23272,35004,-11732
892630,2013,2023-10-25,8245,93676,-85431
913824,5953,2022-12-24,15276,71130,-55854
601190,9082,2024-09-05,9634,54715,-45081
287776,3030,2022-07-20,44646,39645,5001
989383,7680,2024-06-27,67884,24655,43229
483942,2139,2023-06-19,63003,83578,-20575
285227,2556,2022-05-06,47433,88184,-40751
714184,2984,2021-11-17,7315,90055,-82740
538247,7403,2023-04-07,11365,72573,-61208
760906,9441,2023-08-20,17355,57528,-40173
730895,1566,2023-10-06,69758,11944,57814
741280,1496,2022-07-12,51470,36720,14750
666794,4574,2023-02-04,69315,37336,31979
299662,2476,2023-07-04,6299,47401,-41102
296471,9865,2022-04-25,30192,19262,10930
309911,9619,2022-02-28,37401,93871,-56470
662367,8350,2022-04-24,99397,93598,5799
500465,8925,2024-09-05,53104,10687,42417
609300,7225,2022-11-23,50336,97759,-47423
598000,8166,2022-08-04,86343,41427,44916
548750,9478,2022-04-13,30708,91778,-61070
251357,9116,2022-02-17,38250,13768,24482
773575,4107,2023-10-12,26761,82890,-56129
770906,4461,2024-08-15,91405,53649,37756
932660,8968,2022-10-02,3233,21608,-18375
885792,9743,2023-03-19,86735,90342,-3607
202657,5322,2022-11-08,84759,45674,39085
662433,9787,2023-04-11,81233,92660,-11427
429292,4261,2024-03-25,78588,38368,40220
497150,5953,2024-06-19,69036,86765,-17729
151786,1537,2024-07-01,87701,61649,26052
270415,1566,2021-11-28,82532,3041,79491
931512,2991,2022-07-21,44467,41657,2810
255145,8800,2022-05-11,55961,28118,27843
822841,3692,2023-01-13,62972,86703,-23731
843979,8442,2023-02-11,99401,62125,37276
686874,9248,2022-12-20,78308,18856,59452
598691,4241,2023-01-23,20532,21893,-1361
951749,7330,2022-11-27,95367,61055,34312
866432,4084,2023-04-02,81880,93236,-11356
779381,3326,2022-08-01,56502,43551,12951
894998,7401,2024-06-09,64167,61245,2922
630501,1977,2024-08-24,60770,47757,13013
520715,5575,2022-04-09,45275,16639,28636
174715,4465,2022-03-04,31787,81228,-49441
964297,9023,2022-12-19,35349,22624,12725
248639,7225,2021-11-13,30666,87077,-56411
731849,1118,2024-01-25,80629,76675,3954
614426,1537,2023-08-07,57612,7871,49741
551476,7264,2022-01-06,47064,54763,-7699
312569,6290,2022-01-15,75845,67121,8724
392604,8442,2023-11-08,37333,71584,-34251
226293,4950,2022-09-03,95618,25656,69962
340313,8036,2024-08-20,27083,46257,-19174
543978,1396,2023-04-03,28807,4816,23991
609249,4595,2023-02-25,17716,97403,-79687
100738,5604,2022-02-09,31834,21048,10786
597535,5126,2023-02-15,90521,32357,58164
114594,4574,2022-05-07,56138,47320,8818
705210,9903,2023-05-29,27989,14521,13468
192859,8036,2023-11-03,43185,43614,-429
334705,2105,2024-04-30,35211,27635,7576
101960,8442,2023-09-08,7271,45181,-37910
916357,8343,2023-08-11,87200,86266,934
336914,7359,2023-01-07,37983,99570,-61587
462472,8350,2022-10-01,48146,99228,-51082
617415,3832,2023-10-22,32963,43060,-10097
681560,1711,2023-10-09,60670,10080,50590
376380,2398,2021-12-23,85927,65135,20792
575847,3222,2024-05-30,30966,88670,-57704
146219,8905,2022-08-02,85918,65240,20678
665108,4208,2022-12-08,3804,69775,-65971
236744,5597,2021-12-14,30071,24601,5470
553947,8953,2021-10-14,22124,92543,-70419
470810,9010,2023-03-20,29692,42236,-12544
538092,6965,2022-10-28,80819,22928,57891
933031,1308,2022-11-02,53090,30257,22833
974200,5068,2022-06-22,25577,25255,322
812624,1173,2023-11-01,66928,80716,-13788
772577,9474,2024-03-01,72844,54204,18640
733716,9353,2023-01-06,41221,3665,37556
181292,9538,2022-10-03,61601,36789,24812
122434,2193,2022-04-18,22229,66506,-44277
305342,1517,2024-03-04,10758,14168,-3410
898704,7635,2024-08-13,25499,82845,-57346
730094,9132,2022-08-14,36124,6740,29384
929413,5953,2022-12-14,71305,30941,40364
874643,4261,2023-06-05,55344,36404,18940
107534,5319,2024-02-18,36458,17150,19308
185400,5889,2024-01-14,18706,89312,-70606
541813,7530,2023-12-29,3987,89345,-85358
970303,6539,2024-03-07,62940,10081,52859
880726,5330,2023-05-08,3850,72716,-68866
891886,6205,2021-09-25,97278,92891,4387
506700,5247,2024-07-05,1078,79474,-78396
820977,6965,2022-07-22,36110,97915,-61805
560928,2623,2023-02-15,69176,52748,16428
955193,1869,2024-03-21,80136,53476,26660
983270,9322,2024-06-13,84700,14642,70058
266534,4261,2023-04-08,36520,50892,-14372
860016,2991,2022-01-24,30858,5638,25220
657053,2085,2022-08-19,49739,30931,18808
541631,1165,2021-10-17,73941,17843,56098
686810,3291,2023-08-30,33494,24742,8752
168970,8130,2024-02-16,94317,92361,1956
122043,6149,2021-11-23,16203,85830,-69627
829782,4703,2024-07-18,49816,31568,18248
340251,9470,2023-02-07,12128,82748,-70620
144388,5685,2021-10-09,1995,52829,-50834
424562,6726,2022-06-18,26474,12603,13871
840377,4059,2021-10-17,13286,39334,-26048
521236,5158,2022-11-19,30581,70366,-39785
748747,9538,2024-08-18,78607,42643,35964
865440,5336,2022-01-22,33356,39354,-5998
970986,4798,2023-05-09,38947,88980,-50033
307679,8516,2023-03-26,28545,74271,-45726
486858,8725,2024-09-13,44412,59215,-14803
679719,3572,2024-09-17,76768,80365,-3597
522222,6324,2023-03-20,86355,57221,29134
983860,6115,2022-12-29,13250,91494,-78244
919026,7818,2024-03-09,25049,13655,11394
163988,4950,2023-05-24,17080,29832,-12752
813873,5966,2023-04-05,94733,38656,56077
575899,4811,2022-01-03,56702,78197,-21495
283144,9644,2024-06-13,71443,2476,68967
854571,1302,2022-03-04,86189,44259,41930
540663,8999,2022-07-14,13631,3546,10085
231826,3023,2023-03-27,26283,5308,20975
736532,4309,2024-01-25,48595,76963,-28368
501703,1537,2021-12-13,29221,34956,-5735
789851,2085,2022-08-31,33706,15184,18522
911384,2192,2022-01-19,86947,20563,66384
807853,9010,2023-07-20,6024,59130,-53106
673889,7771,2022-08-04,96203,3420,92783
504863,3023,2024-02-13,13045,34547,-21502
924621,1902,2021-11-25,63012,50752,12260
308068,5853,2024-07-03,83585,4708,78877
779097,4461,2021-09-29,10046,47635,-37589
822186,1396,2024-03-31,95482,42376,53106
251872,2939,2023-02-24,10667,58442,-47775
898004,6539,2021-12-22,15541,4603,10938
993342,1250,2023-11-27,50353,50908,-555
391132,4889,2022-07-04,22597,25022,-2425
265747,2251,2022-12-04,16852,75156,-58304
856512,8797,2024-02-06,72363,18604,53759
250505,3015,2023-05-30,49884,96603,-46719
708307,6726,2023-03-20,9217,78162,-68945
705999,2105,2022-10-07,36148,15563,20585
357296,6541,2024-01-21,48662,68593,-19931
117681,6965,2021-12-02,10054,97207,-87153
974284,9327,2024-06-24,90966,87357,3609
296968,7072,2024-08-08,10879,56021,-45142
414473,3015,2022-08-10,17591,41329,-23738
933381,4309,2023-07-27,46376,82534,-36158
128645,2902,2022-11-16,45040,63074,-18034
685434,3934,2022-07-01,33328,26589,6739
582858,5770,2024-03-02,29914,53041,-23127
270811,4574,2024-03-24,46038,7523,38515
937599,6332,2022-12-20,94209,52441,41768
104864,7263,2022-09-19,96783,90030,6753
863599,7771,2024-06-18,96896,46501,50395
952261,5459,2023-11-17,43644,54324,-10680
121832,9981,2024-03-09,5353,31150,-25797
596855,7290,2022-03-14,48798,44092,4706
843551,8582,2024-07-07,78575,33877,44698
187176,2672,2024-06-09,93889,21792,72097
677782,5071,2022-03-15,76225,85471,-9246
142155,1711,2021-10-31,23719,19072,4647
611458,7239,2024-02-02,98712,77975,20737
825187,8968,2022-09-07,41138,19969,21169
396466,7810,2024-05-29,45711,75164,-29453
743702,1732,2024-07-06,14784,48476,-33692
642706,1504,2022-05-11,23152,74163,-51011
779161,7290,2022-01-19,86258,4576,81682
368255,7204,2021-12-29,80499,31414,49085
445682,8011,2024-05-30,61862,66392,-4530
737140,4703,2023-11-09,96280,9467,86813
534969,2902,2023-12-26,83516,41284,42232
342482,8218,2023-05-01,11613,44174,-32561
431969,9841,2024-03-20,54144,5864,48280
887853,9787,2023-03-22,37889,88500,-50611
913434,5247,2023-11-25,2912,5884,-2972
790439,3712,2021-12-09,85436,59306,26130
665155,4198,2021-12-02,46880,92880,-46000
264534,4950,2023-01-23,54362,17112,37250
127501,8992,2023-06-22,97994,55832,42162
624735,9951,2023-02-24,79965,24243,55722
867475,2868,2023-06-26,41706,48582,-6876
258488,8218,2021-10-11,87163,25487,61676
360093,9309,2023-07-07,75736,29450,46286
446426,4574,2023-11-16,13906,96388,-82482
543027,8026,2022-01-26,22928,16330,6598
264140,2901,2022-10-31,59279,42097,17182
483757,2982,2022-01-08,80331,13727,66604
429690,7530,2023-06-05,94775,65732,29043
787297,6371,2024-03-05,75680,54314,21366
530554,9023,2023-02-20,74563,40776,33787
233219,9943,2023-10-25,87671,69618,18053
694760,1118,2022-05-10,44623,66201,-21578
415504,4086,2023-12-20,8812,51781,-42969
539047,1768,2024-04-26,99530,50405,49125
571687,2745,2023-01-12,23131,76796,-53665
262371,9865,2024-01-07,15375,80028,-64653
559508,2288,2022-02-07,1030,98298,-97268
159201,8968,2023-11-10,6768,68144,-61376
370595,3030,2024-07-03,98415,42812,55603
155848,9865,2023-12-09,54462,47068,7394
950056,9322,2023-03-16,75773,53388,22385
508571,6690,2022-10-29,17423,9085,8338
927589,5180,2021-11-23,19977,14419,5558
592164,7898,2022-08-01,35021,4661,30360
768453,2821,2024-06-10,93386,58593,34793
176714,8357,2023-10-24,30922,71589,-40667
759980,4208,2022-11-06,21467,33746,-12279
451762,4461,2022-01-10,98461,16707,81754
661539,3692,2023-02-12,43686,23295,20391
937062,4532,2024-08-21,32668,5439,27229
185683,1063,2021-10-13,7069,1800,5269
364104,9435,2023-02-24,31791,56000,-24209
582084,5385,2022-03-04,31797,54615,-22818
988178,4237,2022-12-30,90191,53521,36670
768258,2230,2022-09-18,57373,55834,1539
883428,8817,2022-04-21,29454,42034,-12580
970328,1750,2024-01-03,77959,50829,27130
874282,3051,2021-12-10,58522,10549,47973
374845,3887,2023-06-01,98482,38365,60117
965201,7415,2023-10-12,86496,88234,-1738
357396,6379,2022-04-14,3229,82203,-78974
876242,7510,2021-12-28,47137,20413,26724
499516,6016,2023-04-22,78209,78615,-406
299582,3022,2022-06-11,81230,70981,10249
631863,9981,2022-02-01,11424,11821,-397
120583,9248,2024-09-23,76329,99076,-22747
205605,4798,2024-01-12,73060,66814,6246
644605,2215,2022-09-13,35215,12349,22866
873984,4237,2024-07-23,81297,46102,35195
746139,4059,2023-03-22,30535,26459,4076
546484,7680,2022-03-06,5347,32814,-27467
915201,2288,2023-07-17,67880,86456,-18576
448965,8357,2024-07-25,97462,33061,64401
586027,4676,2022-07-30,35360,67616,-32256
695202,4676,2023-09-16,39643,93216,-53573
477217,3308,2022-07-22,53277,97669,-44392
423193,3828,2022-09-03,44160,8730,35430
551368,5328,2024-06-16,81582,84287,-2705
708305,7635,2023-08-20,78700,55430,23270
870504,8357,2022-07-31,73730,37289,36441
857126,4177,2024-04-09,79535,23498,56037
681234,2217,2022-09-11,68930,88527,-19597
835529,3144,2022-02-03,45441,82388,-36947
626760,1341,2024-04-16,25173,62060,-36887
604221,1208,2024-03-23,43154,67585,-24431
356422,6821,2022-06-23,77847,15559,62288
529826,7818,2024-06-15,7656,32298,-24642
549675,9128,2024-02-16,35695,36152,-457
933892,8030,2022-05-13,28712,78553,-49841
429787,9787,2023-07-20,58590,37301,21289
818882,5953,2023-07-11,25014,48269,-23255
255063,1063,2022-08-04,71474,1492,69982
691611,5382,2022-01-19,23322,30688,-7366
389426,2176,2024-04-28,70905,88533,-17628
728133,7510,2022-11-28,65682,74537,-8855
777508,6352,2021-12-13,49218,2197,47021
616506,3851,2024-02-20,99110,48219,50891
124454,6688,2022-06-14,26962,87973,-61011
838455,8905,2021-12-25,29628,25917,3711
601922,4663,2021-11-20,37502,12155,25347
875102,1008,2022-08-04,4657,59057,-54400
397572,6691,2022-07-11,31294,12213,19081
397553,2398,2024-08-15,41964,98886,-56922
389801,8218,2022-04-12,78796,7261,71535
417407,8469,2022-11-12,85488,19548,65940
411470,9128,2021-10-28,51961,1910,50051
540383,2857,2022-09-02,15013,64260,-49247
260764,4100,2023-11-28,89974,15921,74053
699118,9207,2023-05-09,21300,26785,-5485
115254,9731,2023-07-23,29060,38438,-9378
781997,2450,2023-04-23,63013,41660,21353
888711,9116,2022-05-19,91127,88666,2461
138700,6290,2022-11-03,8726,35309,-26583
569854,6452,2022-10-18,27008,9200,17808
649070,2408,2024-07-03,99823,11338,88485
290483,8218,2022-05-12,19294,31755,-12461
946483,8740,2023-01-12,72396,54485,17911
822997,4237,2022-04-10,7706,4352,3354
279813,8970,2023-10-20,56440,65428,-8988
511744,6759,2023-05-20,38765,22274,16491
519259,7470,2022-02-21,50094,56187,-6093
146360,4689,2021-10-01,53365,4274,49091
365700,8992,2023-05-01,40268,22073,18195
218335,3326,2022-10-10,68093,43500,24593
868859,7359,2023-07-13,26088,11546,14542
685635,7166,2024-09-24,75536,80897,-5361
907103,5965,2024-04-03,99122,69457,29665
450731,1537,2023-11-26,24727,63606,-38879
596072,4896,2021-11-01,95007,40641,54366
666894,1768,2023-01-10,47981,40809,7172
721076,2176,2022-02-11,78052,32540,45512
135942,4227,2022-05-01,93019,44666,48353
347292,8350,2023-11-30,93999,35140,58859
210293,9060,2022-05-01,43934,12888,31046
275056,7401,2022-07-09,46841,46308,533
422837,9010,2022-03-06,46674,16163,30511
968410,8992,2023-05-30,98068,55191,42877
645571,1148,2024-07-29,4212,77108,-72896
453380,7359,2023-06-16,80589,56444,24145
685787,6965,2021-10-26,13473,84016,-70543
677114,4606,2022-07-15,15806,51627,-35821
723446,9055,2022-06-21,20053,42417,-22364
495975,8462,2023-11-11,89441,43253,46188
528427,1880,2022-03-12,14933,51744,-36811
782585,1948,2023-05-12,88858,39685,49173
378087,3326,2022-03-14,81532,23182,58350
577165,1808,2021-11-09,55356,61765,-6409
930013,8797,2024-02-20,81491,2830,78661
217848,7501,2023-09-28,62099,98667,-36568
279199,4100,2022-10-21,85979,7822,78157
554709,5953,2024-06-01,85078,91962,-6884
646921,9207,2023-06-07,9951,40539,-30588
361026,4227,2022-07-16,78359,22143,56216
812951,5247,2023-08-22,42476,35667,6809
173826,1711,2024-06-19,34168,49898,-15730
624263,5817,2023-08-06,45462,36006,9456
614450,3411,2022-09-26,69902,47887,22015
610882,8740,2021-11-29,6080,1515,4565
985219,2556,2023-09-30,83249,50336,32913
803505,9435,2023-09-15,66716,92046,-25330
750894,2857,2022-09-17,46325,91018,-44693
906968,7786,2021-10-03,77360,91585,-14225
777040,2611,2021-12-28,69584,19652,49932
393210,1216,2023-08-07,31983,20073,11910
529506,5808,2022-07-12,90447,7873,82574
946205,1768,2022-09-14,90006,78909,11097
933520,5180,2022-03-22,56609,99693,-43084
619966,6083,2023-10-03,5136,80305,-75169
774743,7095,2023-03-25,43586,57676,-14090
297580,6023,2023-04-15,50577,76266,-25689
343725,9865,2023-12-03,86242,62332,23910
827008,7239,2022-05-30,37995,75975,-37980
847947,5071,2023-03-30,15298,5595,9703
469020,1517,2022-12-20,48340,74646,-26306
322552,3072,2022-12-09,14190,37612,-23422
508664,7530,2022-05-29,33768,87856,-54088
112845,7174,2024-09-12,7617,2705,4912
352120,9804,2023-10-20,22106,60418,-38312
361073,7454,2022-08-24,71449,75222,-3773
261830,9082,2023-07-06,30447,5435,25012
165192,2213,2021-12-22,16032,7060,8972
193929,9295,2024-05-26,14420,6138,8282
147337,9787,2022-06-15,14567,69255,-54688
908311,5328,2022-01-30,26922,73689,-46767
113952,5004,2022-03-04,33767,65413,-31646
778302,4177,2023-12-30,76660,82537,-5877
215606,1308,2022-06-06,1092,18807,-17715
370076,7359,2022-05-18,57759,75818,-18059
314000,8800,2022-05-04,35382,93273,-57891
423118,7662,2022-02-12,72816,93128,-20312
326546,2045,2023-04-18,16326,98997,-82671
794102,3194,2022-11-13,7715,19375,-11660
522364,6229,2024-07-25,14177,72292,-58115
361508,6663,2023-08-27,59670,61129,-1459
522616,5882,2021-12-09,68957,57783,11174
221997,4478,2022-03-08,45188,35166,10022
680306,7530,2023-01-05,29167,15938,13229
344027,4100,2023-07-02,64374,10511,53863
988803,6083,2024-09-05,75526,97378,-21852
366688,3559,2022-12-22,42509,43384,-875
247172,9060,2022-07-02,88714,52505,36209
378958,4689,2021-11-06,50109,7165,42944
765712,9915,2023-07-19,53398,61267,-7869
593498,4208,2023-03-22,93111,23963,69148
677874,6016,2022-04-05,42873,85811,-42938
971920,7771,2024-09-09,88054,78879,9175
282786,6319,2024-01-14,98749,34375,64374
959191,8483,2022-10-07,46476,42472,4004
887036,5158,2024-05-31,18889,78056,-59167
911464,5071,2022-01-28,71643,4585,67058
551832,4663,2024-05-11,3493,81902,-78409
295547,4208,2022-06-20,23890,30048,-6158
293176,4091,2023-05-13,37633,97332,-59699
992065,9841,2022-01-06,63339,59311,4028
836191,5894,2024-02-22,66683,1362,65321
971377,8319,2024-04-09,69324,12583,56741
374616,3264,2024-08-24,91666,74968,16698
711884,7072,2022-03-20,60746,58792,1954
525738,4947,2024-09-13,79772,84813,-5041
510036,1785,2024-01-29,72624,84198,-11574
452206,8925,2022-05-23,26332,70923,-44591
664293,9694,2023-10-09,31941,70270,-38329
528042,7501,2024-09-22,72163,12316,59847
979344,6563,2022-01-31,58279,16071,42208
985106,5988,2022-08-29,24265,39283,-15018
291816,3572,2023-01-28,78149,76996,1153
267559,1566,2024-05-31,2647,59439,-56792
563856,8647,2022-03-17,35142,35271,-129
378263,2398,2022-08-19,1103,45510,-44407
860825,8218,2024-08-09,13245,22634,-9389
741209,7225,2022-08-27,46223,44310,1913
321240,5007,2023-04-10,46786,9147,37639
781871,3267,2022-06-18,62907,92762,-29855
931697,5126,2023-03-08,39987,28136,11851
141754,5330,2022-08-08,7430,99711,-92281
464307,6379,2024-06-14,2927,26224,-23297
583153,7204,2024-03-08,61016,12937,48079
379232,8460,2022-10-02,72392,10986,61406
890583,7454,2023-09-30,67482,57004,10478
215849,1118,2024-07-30,90793,41954,48839
687274,1732,2022-04-19,83329,51841,31488
804632,9903,2022-04-09,64039,16859,47180
881661,4241,2022-04-13,52087,15753,36334
238735,8987,2023-05-08,18563,52299,-33736
412011,8026,2023-02-03,87575,67306,20269
598908,5894,2023-06-13,7519,92698,-85179
664411,3072,2022-04-12,12119,95564,-83445
550662,4900,2021-12-17,25663,21019,4644
638215,7898,2022-11-20,83542,24507,59035
402116,9951,2022-05-24,8191,10783,-2592
566822,8350,2023-02-03,45036,53730,-8694
772180,4780,2023-11-26,23329,98872,-75543
988464,8357,2023-07-07,71615,49124,22491
794815,1179,2024-05-30,97445,80994,16451
246061,9353,2022-10-26,85378,79598,5780
855080,1341,2023-01-10,88545,73539,15006
863510,8319,2022-10-22,77155,99727,-22572
955240,8976,2023-12-16,18734,95241,-76507
768904,3891,2023-03-16,65226,44744,20482
930723,5525,2023-03-23,3442,47206,-43764
593794,5685,2022-08-13,11849,19634,-7785
166018,7330,2022-04-16,39961,3325,36636
576401,5171,2022-05-01,74430,20155,54275
742956,4699,2023-01-31,51692,40170,11522
648241,8462,2024-06-12,12518,94783,-82265
922752,7403,2024-08-07,21309,28927,-7618
143346,9197,2022-07-10,46632,68622,-21990
314609,5157,2022-05-07,71119,20273,50846
196325,5386,2023-01-09,52925,93647,-40722
427933,9399,2023-04-04,46995,54411,-7416
627049,4735,2024-05-30,24638,64744,-40106
348575,4237,2023-05-31,79141,37167,41974
464724,5079,2022-11-16,65002,96062,-31060
217833,1165,2021-09-25,78818,78981,-163
869276,8516,2024-08-19,91612,96579,-4967
530904,2105,2022-05-07,77322,38745,38577
574905,5705,2022-12-13,66762,52534,14228
401849,5889,2024-03-24,33326,77278,-43952
400423,6691,2022-08-29,38085,26807,11278
120215,7166,2024-07-16,74853,25348,49505
865180,4676,2021-11-15,7261,51314,-44053
783190,8989,2023-02-20,2234,26964,-24730
686152,4245,2022-07-16,82775,16078,66697
257961,1880,2023-01-25,28571,9394,19177
187703,3291,2023-06-13,28830,55440,-26610
353109,4726,2022-06-19,73717,12443,61274
860678,8350,2024-01-04,52239,75839,-23600
475796,3326,2024-02-01,56682,83198,-26516
576572,5330,2023-03-23,71927,85823,-13896
239438,1286,2022-01-06,51125,15656,35469
782044,6280,2023-12-27,4776,91696,-86920
754058,1227,2023-06-28,48381,27888,20493
341156,9538,2022-10-02,18476,20358,-1882
576700,2105,2022-12-24,12438,65923,-53485
825854,5126,2022-09-22,76914,89570,-12656
882774,4165,2023-04-30,50601,89250,-38649
822282,3891,2024-03-12,53030,67023,-13993
616465,8319,2023-09-20,31757,4842,26915
287942,1869,2022-06-22,68940,49515,19425
129883,4689,2021-12-14,82818,74964,7854
959523,9197,2024-02-05,54087,49477,4610
257553,2940,2021-11-02,46610,65117,-18507
880610,5953,2022-09-18,61827,99141,-37314
971364,4676,2024-09-02,20061,26386,-6325
324913,2937,2023-02-23,68640,45449,23191
248383,9470,2023-05-19,82204,61260,20944
417818,7470,2023-11-23,78188,29614,48574
146419,8976,2021-12-09,97639,90068,7571
333754,5749,2022-09-07,11157,5628,5529
861190,9295,2024-04-05,77479,26865,50614
167243,6324,2024-05-28,63841,41854,21987
752501,9223,2023-06-30,22316,64244,-41928
536109,6290,2023-10-12,69060,41837,27223
298376,5336,2023-06-19,26696,46203,-19507
250402,7011,2024-02-16,71583,71865,-282
699045,5007,2022-02-02,46479,27298,19181
649040,8483,2024-09-24,95167,20107,75060
208917,6347,2022-04-23,35035,74874,-39839
819050,1194,2021-11-14,4733,36677,-31944
701056,9644,2021-12-10,95153,4078,91075
282293,4261,2023-07-25,98266,9007,89259
733667,5604,2024-06-09,13604,97464,-83860
662711,9596,2022-01-26,44394,8406,35988
680192,4539,2022-07-18,2454,3212,-758
255585,2176,2024-03-02,24046,56341,-32295
957516,5853,2023-11-03,83401,3159,80242
918221,1651,2021-10-18,85307,71761,13546
935421,7359,2022-02-17,81132,41920,39212
542577,8691,2024-06-26,82273,71396,10877
303149,5247,2024-07-31,60863,5443,55420
648417,5007,2023-09-24,7280,2311,4969
979053,2556,2022-02-06,34594,89875,-55281
291027,7771,2022-01-01,45194,56063,-10869
838691,2785,2024-04-19,89510,28412,61098
304484,7786,2023-05-06,70479,2079,68400
917449,5749,2022-09-11,14107,5984,8123
693046,3776,2024-06-16,84597,68304,16293
796191,1553,2022-08-27,87286,94889,-7603
777579,1063,2021-12-05,9047,85367,-76320
711907,4432,2021-09-29,18210,36816,-18606
477155,1537,2024-01-02,48277,70860,-22583
409395,1194,2022-12-16,18347,18780,-433
591900,3144,2024-09-11,39822,64015,-24193
191091,9804,2022-03-28,1820,65254,-63434
107591,3411,2021-11-12,4759,62753,-57994
659648,8350,2022-04-22,34606,19965,14641
252651,9865,2022-09-14,32751,68514,-35763
189698,2640,2022-01-25,83698,30254,53444
165023,5941,2022-11-24,47879,48463,-584
608458,7256,2023-04-09,16860,73926,-57066
230811,8226,2022-02-13,39964,58455,-18491
188701,7898,2022-09-03,99502,4762,94740
468415,1308,2022-09-04,12488,75621,-63133
317174,8702,2024-08-03,47281,99126,-51845
608648,9818,2024-09-08,55870,13738,42132
970446,5685,2024-08-10,56833,79576,-22743
595722,1553,2024-01-15,24688,12317,12371
152767,5882,2023-12-22,67016,58528,8488
152886,4735,2023-11-30,80579,94068,-13489
219562,5328,2024-07-28,4700,48102,-43402
253070,8989,2022-11-08,69662,71129,-1467
613602,7120,2024-01-21,25049,71794,-46745
878264,6663,2022-02-07,83620,35325,48295
368682,9941,2022-02-15,76806,34077,42729
524416,2869,2024-09-05,20967,89620,-68653
376180,5068,2022-04-18,98443,66876,31567
220834,5808,2022-11-17,73175,99689,-26514
375739,2450,2024-02-01,31997,23618,8379
162027,7395,2022-04-10,19475,81004,-61529
878966,3015,2024-06-14,90296,82229,8067
424992,8647,2022-09-10,60575,3248,57327
440223,9116,2023-09-29,25923,4339,21584
690841,8130,2023-02-05,75401,43561,31840
447506,9915,2024-05-14,9139,94131,-84992
259073,8460,2024-06-02,22836,27506,-4670
709922,2640,2023-06-05,90654,53132,37522
616255,6821,2023-11-07,72025,76574,-4549
148773,5604,2024-08-13,76059,58284,17775
643738,6759,2024-03-19,81395,52248,29147
490398,7231,2024-06-30,55309,25281,30028
132689,9235,2022-01-09,34955,40237,-5282
614062,2821,2024-02-29,75006,86220,-11214
742811,7166,2022-01-15,79179,36178,43001
876010,3264,2024-04-28,68040,22723,45317
800661,3721,2023-07-07,2558,97114,-94556
936497,5785,2023-05-15,13983,32791,-18808
708550,7635,2023-02-12,52413,5109,47304
407704,7470,2023-03-08,15535,88041,-72506
150886,1517,2023-03-18,26960,25644,1316
847737,7818,2022-09-25,57385,98099,-40714
512628,6352,2023-07-08,44383,28335,16048
586244,1537,2023-03-19,25274,22500,2774
560452,5464,2022-01-05,34683,43638,-8955
708036,6917,2023-11-22,18749,69860,-51111
947669,5894,2022-09-01,12225,76251,-64026
630909,8987,2024-02-05,26379,67752,-41373
998291,4208,2023-08-09,56879,88162,-31283
217753,8976,2022-05-31,62274,63823,-1549
694710,9012,2021-12-13,15795,73968,-58173
239407,1435,2024-03-04,36403,62133,-25730
911367,1882,2021-10-19,57045,62987,-5942
561310,2210,2023-01-24,83048,17990,65058
509889,5484,2023-06-15,47261,14681,32580
689371,7670,2024-01-11,15274,63579,-48305
764567,7359,2022-04-26,20182,80170,-59988
805035,5330,2023-01-12,83493,47308,36185
976654,2611,2022-05-30,26662,64001,-37339
353454,6880,2024-01-11,96372,15910,80462
952783,8905,2022-06-15,34987,26016,8971
820884,8702,2023-11-24,54674,31868,22806
825727,7786,2022-12-08,33732,79674,-45942
701793,5322,2022-03-13,27042,64562,-37520
895539,2192,2024-01-26,88707,81929,6778
834416,1227,2021-11-11,85931,75573,10358
531588,2398,2021-12-11,37536,36990,546
434264,9596,2022-08-09,45636,70130,-24494
373214,9116,2023-02-17,39141,51776,-12635
533586,1497,2023-08-17,16410,55699,-39289
878380,2902,2023-10-23,17249,9180,8069
181062,9295,2023-08-31,67263,33517,33746
247417,7008,2023-06-01,75063,53677,21386
444942,9060,2024-01-15,32150,93532,-61382
588772,9817,2024-03-17,7244,11797,-4553
137939,3326,2024-02-09,67015,34213,32802
362435,2176,2023-01-14,2589,98258,-95669
411392,1208,2023-12-05,52745,88808,-36063
596023,4127,2023-10-13,46213,4253,41960
848738,1948,2024-02-12,63632,95284,-31652
227919,5268,2023-11-14,13055,13464,-409
294552,2426,2023-01-24,74720,29370,45350
793724,5180,2023-05-19,93918,92178,1740
240503,1948,2024-07-28,73831,39571,34260
590219,4699,2022-10-02,8330,12764,-4434
200108,1208,2022-03-15,7350,54556,-47206
328437,6229,2024-03-21,52829,46558,6271
483642,4363,2024-08-17,11372,99550,-88178
784653,1286,2022-03-13,74017,72109,1908
704076,3498,2021-09-30,85607,48829,36778
725149,9719,2023-10-22,70242,5320,64922
519056,1448,2023-03-16,59408,28704,30704
364760,8357,2024-02-04,28493,70690,-42197
240651,5941,2022-05-29,7893,11975,-4082
194357,2355,2022-05-14,85510,21259,64251
266405,3308,2022-02-22,84251,26433,57818
584710,4367,2022-03-31,30326,27179,3147
967243,9865,2022-06-24,3819,83599,-79780
585192,9128,2023-10-12,45040,21293,23747
946223,4309,2024-06-23,61606,71592,-9986
161374,7732,2022-10-23,25582,79470,-53888
948960,5240,2024-09-06,32434,33780,-1346
861959,9694,2022-03-17,35028,44999,-9971
918196,7174,2022-04-08,63788,99192,-35404
651060,5247,2024-03-07,68115,47579,20536
576933,4084,2022-04-15,83455,98107,-14652
933811,6726,2022-04-15,72192,78351,-6159
684803,7942,2024-08-18,16915,62672,-45757
673556,1208,2023-10-14,26447,55607,-29160
678772,2863,2022-01-03,45027,41415,3612
652844,5894,2023-10-27,8034,41523,-33489
691662,8218,2024-01-08,50782,94153,-43371
749716,4889,2023-08-01,14722,30678,-15956
154468,2476,2022-02-24,56520,7844,48676
876098,2074,2023-01-29,58179,87565,-29386
105074,1517,2023-03-11,3878,50960,-47082
467363,1479,2022-04-09,40069,24376,15693
160714,4780,2022-02-27,12973,28850,-15877
889320,8026,2022-07-09,89644,84300,5344
749565,5126,2024-07-29,40129,23820,16309
365668,7239,2022-01-31,35445,43352,-7907
936223,4689,2024-09-17,37910,72985,-35075
673112,4947,2023-03-08,89050,80356,8694
979061,4272,2024-03-10,18577,24047,-5470
641402,9804,2021-09-27,46892,47620,-728
118071,4950,2022-02-25,90574,4022,86552
219062,9981,2022-02-10,39428,16320,23108
440497,5319,2024-02-09,2279,64507,-62228
878514,9255,2022-11-11,17904,85885,-67981
774899,2426,2024-01-10,31894,21768,10126
666112,6150,2023-07-27,29752,94275,-64523
813907,4539,2022-07-14,42009,86475,-44466
721448,8905,2024-02-27,10108,77620,-67512
574999,8576,2023-05-14,29752,53414,-23662
687624,3319,2022-03-18,88664,14247,74417
764779,2450,2023-11-26,56576,46246,10330
494565,5319,2022-04-19,17003,19023,-2020
189437,4461,2021-11-27,88875,8372,80503
680280,8319,2022-08-22,39940,52051,-12111
349945,2476,2022-12-22,3348,42959,-39611
234012,8011,2024-02-18,15674,56432,-40758
929099,8999,2022-06-22,21047,43123,-22076
688822,4798,2024-07-14,18681,90724,-72043
194797,4532,2023-08-14,88663,92408,-3745
118433,5990,2022-04-07,87552,21353,66199
567119,5941,2022-12-26,88561,23212,65349
820807,5484,2024-01-29,10234,86602,-76368
668615,6080,2023-06-23,26307,3552,22755
835146,6539,2022-04-24,60351,86143,-25792
514286,7680,2024-06-19,25183,64106,-38923
625964,8130,2023-04-15,89894,28978,60916
749399,5592,2021-12-18,52539,44509,8030
479515,3572,2022-05-06,71194,73757,-2563
270477,8800,2024-07-15,42013,97478,-55465
145142,3072,2024-06-07,30756,7670,23086
987060,5894,2022-06-25,56641,67412,-10771
788163,1768,2022-06-28,10194,65922,-55728
553809,8721,2024-01-09,93776,26827,66949
698442,6917,2024-09-19,57236,30116,27120
271095,9731,2024-01-09,21721,95168,-73447
649194,7501,2022-11-18,35886,44550,-8664
251593,7072,2023-10-08,28403,29472,-1069
511309,3832,2022-06-16,43799,30909,12890
983280,1208,2022-12-08,76482,36813,39669
713433,6318,2024-08-23,95068,82988,12080
141971,2984,2022-12-21,43212,65794,-22582
465810,2688,2021-10-13,96085,68263,27822
950487,2011,2024-05-01,82446,83556,-1110
953887,8662,2022-03-26,38141,62226,-24085
783196,8513,2024-01-08,51368,83791,-32423
893386,1520,2024-08-23,70474,76365,-5891
468023,7942,2024-09-17,25569,96785,-71216
210828,9223,2023-12-10,4029,4481,-452
655048,1286,2022-12-04,11633,7763,3870
260947,2984,2023-07-25,18004,39039,-21035
551248,6115,2022-08-28,97635,6986,90649
779212,9007,2022-05-03,66874,84784,-17910
108956,6726,2022-10-30,18342,32060,-13718
986497,5386,2022-01-26,78807,46682,32125
512682,8582,2024-06-01,91002,10531,80471
409637,5713,2023-05-12,58277,61535,-3258
560161,8987,2024-07-05,68775,80841,-12066
338740,8110,2024-07-30,26460,92597,-66137
414425,6149,2022-06-11,40856,80804,-39948
406487,6821,2023-10-05,93215,80228,12987
466889,5685,2024-05-26,75370,75524,-154
583299,3368,2023-05-30,82189,16723,65466
695219,1520,2022-08-12,22289,23306,-1017
584275,6332,2022-08-29,11477,97321,-85844
710006,2085,2023-08-11,73533,9826,63707
194239,2330,2022-04-28,60449,46808,13641
507635,3194,2023-04-11,40985,89789,-48804
790021,8647,2023-08-24,8705,54654,-45949
543073,4346,2023-07-29,89110,17130,71980
475020,6332,2023-12-01,5324,11733,-6409
850209,7256,2022-06-29,10319,2047,8272
641134,9441,2021-12-16,63925,49884,14041
295622,1651,2024-06-28,41124,20930,20194
672617,5336,2024-05-04,85812,47908,37904
458880,9910,2022-08-14,48008,93537,-45529
638740,2937,2023-06-05,2394,69499,-67105
130392,9841,2022-07-13,11346,32298,-20952
322517,2426,2024-01-10,83148,73289,9859
492225,5386,2023-09-16,41038,5830,35208
249484,1376,2023-04-17,41780,25297,16483
470257,2711,2024-01-23,5858,8522,-2664
715101,1768,2022-03-14,47871,79988,-32117
984834,9818,2023-12-04,6090,18903,-12813
758539,2089,2022-01-16,35017,46756,-11739
714063,7501,2024-05-03,96941,76534,20407
967966,2288,2021-12-02,51932,34001,17931
360204,9322,2022-05-15,97693,55074,42619
168888,6150,2022-11-22,2122,66192,-64070
197096,4432,2024-04-29,58279,36950,21329
363932,5322,2021-12-30,41438,60594,-19156
177521,9865,2024-03-10,35121,70636,-35515
779020,7223,2022-06-28,26094,18263,7831
185943,2408,2022-01-29,97016,10247,86769
786882,5464,2023-09-19,42150,97315,-55165
834342,5192,2021-10-21,6199,93845,-87646
769395,3791,2023-09-05,55424,96517,-41093
518841,5988,2023-04-27,58601,83218,-24617
449087,2902,2023-10-13,67130,2576,64554
148362,4574,2023-08-18,35718,61537,-25819
950861,4369,2024-02-20,33193,77528,-44335
762359,5126,2022-01-29,35665,49116,-13451
414699,1302,2024-07-02,89829,1247,88582
904411,5990,2021-12-20,44692,66450,-21758
350669,3319,2021-11-18,61267,30619,30648
985114,4574,2023-09-01,8022,24341,-16319
923879,6318,2021-12-31,41948,51168,-9220
389880,6150,2024-01-22,2857,80196,-77339
566409,2408,2022-09-20,50934,34090,16844
196807,2692,2023-03-26,99558,30415,69143
661327,3712,2022-11-29,23807,93303,-69496
787530,4086,2024-05-27,6094,39471,-33377
421182,4198,2022-08-26,67484,6054,61430
563141,1448,2023-05-02,6701,8297,-1596
382097,2194,2024-07-27,5550,30558,-25008
339798,2476,2023-07-11,67631,89819,-22188
451033,7290,2024-02-13,69290,97766,-28476
264637,9865,2024-03-18,49685,70266,-20581
216981,9901,2024-03-26,10813,16892,-6079
445042,4900,2024-02-24,91462,85500,5962
329520,4465,2023-01-19,11669,38138,-26469
617088,7166,2022-12-05,48132,38286,9846
670399,3721,2022-10-19,20556,57625,-37069
131217,7670,2023-04-07,70175,69260,915
950688,3692,2022-11-24,32987,68267,-35280
952389,7732,2024-09-13,48917,38070,10847
805490,5713,2024-09-10,86348,37679,48669
181323,2045,2024-04-14,22477,96382,-73905
953595,2902,2023-12-03,16203,74149,-57946
154730,9082,2022-01-17,73201,92210,-19009
335621,4309,2021-12-03,35505,84551,-49046
892226,5986,2023-03-05,21782,48122,-26340
796930,8976,2022-09-22,65007,53901,11106
715034,9672,2022-03-20,47088,23129,23959
162130,4900,2022-08-30,46271,63045,-16774
720606,5268,2023-08-26,3114,37375,-34261
490418,3721,2024-06-10,65611,96518,-30907
681013,7152,2022-05-07,53348,74333,-20985
957154,9317,2024-08-17,57015,45657,11358
252911,8662,2024-08-25,78545,62367,16178
141514,1435,2021-12-18,2817,30364,-27547
303087,7095,2022-08-14,36030,40336,-4306
556339,9010,2023-12-30,96607,41373,55234
393876,2450,2022-10-05,28949,96802,-67853
907353,9470,2023-08-06,29001,78528,-49527
750293,5171,2022-12-13,88294,53653,34641
235996,4363,2024-01-25,29660,17342,12318
449327,5592,2023-12-09,1618,86317,-84699
608071,9327,2024-06-05,51147,52393,-1246
313701,9055,2022-02-09,2563,46197,-43634
447036,1768,2024-02-11,80246,12624,67622
590088,2398,2024-08-06,84652,54834,29818
405404,4224,2024-02-08,97720,65583,32137
461977,5171,2021-10-13,8587,33353,-24766
672058,8905,2021-12-27,13543,18015,-4472
193671,4363,2022-03-28,3727,92059,-88332
447195,9915,2022-09-01,84400,97504,-13104
213834,5330,2022-05-03,86639,77238,9401
274279,9442,2023-02-17,65776,42826,22950
748809,6023,2022-11-26,4105,4734,-629
482986,7662,2021-12-29,48198,87896,-39698
459056,2711,2021-11-07,43293,25327,17966
546760,2640,2022-06-17,40899,5762,35137
359582,8425,2023-08-13,92290,14319,77971
810253,2215,2024-02-14,77445,26636,50809
358914,6290,2024-07-01,90219,14978,75241
479753,8037,2023-05-19,51219,3801,47418
923656,1216,2022-08-10,81229,48396,32833
281070,3051,2024-03-29,51585,35427,16158
927177,9731,2022-07-12,64172,32772,31400
607762,2688,2022-08-09,91833,61941,29892
287771,4896,2023-07-20,4752,48574,-43822
293538,9901,2024-07-05,14815,90902,-76087
987575,8226,2023-06-19,48096,79872,-31776
998369,6541,2022-05-13,99818,45858,53960
785393,7443,2023-10-04,63824,58773,5051
737431,5336,2024-09-06,28028,49963,-21935
495405,9619,2022-05-09,32514,16419,16095
729769,6115,2022-08-14,61142,31224,29918
175560,1008,2023-09-28,85134,98408,-13274
426404,1302,2023-05-07,97363,67790,29573
764824,8740,2024-03-06,4923,83231,-78308
565269,3144,2024-07-06,77349,17395,59954
565148,2426,2022-11-06,31543,56590,-25047
610561,6319,2022-11-03,86168,45663,40505
623522,9470,2021-11-01,38453,47205,-8752
402942,7818,2023-12-15,5030,30803,-25773
288023,6379,2022-08-09,73631,53003,20628
215208,5319,2024-08-05,52220,70500,-18280
154872,7225,2022-07-14,11329,50023,-38694
254590,5941,2023-08-22,66306,6204,60102
450458,1179,2024-06-06,64439,24734,39705
108890,7786,2021-10-12,37691,72855,-35164
532492,3411,2022-04-05,58116,53120,4996
371522,9399,2022-07-31,52526,43306,9220
309514,2230,2021-12-02,14275,79494,-65219
148966,8357,2023-10-12,70385,91691,-21306
270468,2194,2022-10-19,97347,92587,4760
681749,6969,2023-02-11,57070,60180,-3110
600934,9012,2024-04-02,15214,16915,-1701
827582,2085,2023-02-13,47134,45672,1462
544644,9441,2024-03-22,5481,23939,-18458
621615,8516,2021-11-20,46673,34816,11857
285375,4243,2022-09-10,2443,77100,-74657
485222,4059,2021-12-17,94754,27069,67685
984381,7174,2023-01-09,73904,98097,-24193
857512,6080,2023-07-09,57117,15751,41366
813613,8622,2023-11-27,24458,70832,-46374
540795,6663,2023-10-04,72072,78645,-6573
794982,1063,2023-07-20,60776,97669,-36893
433692,3194,2024-02-29,91879,90050,1829
115277,2939,2022-10-27,84816,25805,59011
751857,4735,2024-02-16,4601,99985,-95384
818082,8999,2022-12-20,79742,72560,7182
475312,4735,2024-08-24,52757,91637,-38880
311777,3194,2022-06-20,32751,75486,-42735
583060,9619,2024-07-17,19449,48564,-29115
957958,7008,2022-04-05,97041,55951,41090
607092,8218,2021-11-14,72807,60632,12175
756678,7095,2022-12-21,36534,73449,-36915
539920,3319,2024-06-20,39277,3937,35340
756117,2863,2022-04-29,61574,19015,42559
993796,1496,2023-08-25,10307,54744,-44437
916370,5604,2023-10-03,56245,5892,50353
121342,2105,2023-04-10,34660,6849,27811
169722,5386,2022-06-06,47006,52359,-5353
761442,5382,2022-08-24,52781,97278,-44497
212210,9619,2024-06-14,27574,23001,4573
423922,7818,2022-05-17,72704,92855,-20151
566147,1768,2023-05-28,6889,97791,-90902
634365,5171,2023-03-22,21898,87319,-65421
583477,8483,2022-09-01,45583,55357,-9774
464038,1082,2024-08-12,76457,37516,38941
566361,9787,2022-07-05,86980,34426,52554
759519,4896,2024-05-08,31655,67857,-36202
794400,1768,2024-08-14,87719,73654,14065
179239,5525,2022-01-10,99618,75733,23885
351696,4811,2022-02-04,22461,51318,-28857
857408,4309,2023-11-11,91190,76417,14773
625996,9644,2024-01-17,22082,75365,-53283
241016,4968,2023-11-15,51756,65024,-13268
311183,9295,2022-10-20,77608,32534,45074
986795,6563,2024-02-12,86784,7573,79211
732822,5180,2024-01-16,28753,80043,-51290
746885,7898,2023-07-14,34800,55454,-20654
951141,9309,2023-08-24,43638,53226,-9588
158345,5953,2021-11-29,97918,45531,52387
450299,5713,2023-10-06,7708,38204,-30496
134852,5798,2024-09-11,77998,39522,38476
339094,7264,2023-10-13,21521,52805,-31284
108853,9817,2023-08-09,46441,72325,-25884
299808,8226,2023-10-29,96495,48845,47650
908796,5319,2024-08-12,41111,29425,11686
801826,9535,2023-11-29,32288,16523,15765
591269,7911,2023-10-20,87500,70448,17052
439011,2579,2024-02-11,38049,14816,23233
395085,1176,2021-09-25,67194,39912,27282
230689,6563,2021-11-07,81050,17718,63332
888422,2937,2022-09-08,52254,77011,-24757
720077,8462,2024-01-18,18691,37036,-18345
952676,9865,2023-02-01,82283,17877,64406
251889,6917,2024-08-26,35703,12970,22733
930640,5705,2022-05-08,57971,94203,-36232
669179,1473,2024-07-29,94028,26939,67089
447373,6690,2023-09-10,46316,82132,-35816
554324,8469,2022-12-16,73358,32986,40372
111266,7028,2022-07-28,11673,82931,-71258
603230,9535,2024-05-25,75614,83291,-7677
947476,1553,2023-02-04,28904,79656,-50752
516498,9353,2023-06-19,28621,43906,-15285
674091,8576,2022-02-28,13140,81308,-68168
397770,4245,2023-10-11,43683,93409,-49726
203852,1566,2023-10-06,74670,14778,59892
812558,4811,2024-09-14,66387,29678,36709
919160,5966,2022-10-01,49865,78669,-28804
635537,1735,2022-09-27,64108,97649,-33541
971477,7132,2023-04-29,70429,74044,-3615
629109,5749,2022-05-16,78233,30323,47910
875871,4465,2021-11-16,79788,56547,23241
306161,5990,2022-12-10,52017,97613,-45596
809192,3116,2024-07-23,11050,84825,-73775
527374,2450,2024-01-22,39270,51519,-12249
622737,9672,2024-09-05,28839,95594,-66755
819775,5817,2024-06-03,40529,41497,-968
841692,2426,2024-03-23,73093,48645,24448
747872,6229,2022-06-08,34544,49380,-14836
909194,5685,2023-03-03,70879,95990,-25111
335894,9023,2022-07-22,42123,54463,-12340
972559,3072,2023-02-18,31280,66892,-35612
692271,9743,2023-05-26,98533,87461,11072
415175,5382,2024-08-19,60438,55142,5296
387030,4595,2023-02-03,86775,77510,9265
845585,5882,2024-08-05,72271,17378,54893
549910,6917,2022-05-26,63214,48018,15196
470516,3194,2023-01-27,50698,73789,-23091
956011,7256,2024-06-17,52594,94360,-41766
627278,3934,2021-10-16,12276,81128,-68852
420905,6229,2022-11-23,99117,99267,-150
968945,5427,2023-08-08,18150,70638,-52488
313398,8026,2022-05-16,19239,73239,-54000
788935,1768,2021-10-21,4793,64518,-59725
784296,7330,2024-01-18,58512,7286,51226
751952,4798,2023-12-10,71258,28296,42962
541355,8469,2022-02-07,89519,21677,67842
791950,1008,2024-05-17,39590,84769,-45179
879918,8358,2022-12-14,45128,1131,43997
809561,2857,2021-10-29,61759,30023,31736
854558,2868,2022-09-23,53163,81751,-28588
632366,6229,2023-05-26,57298,92337,-35039
527305,1165,2022-08-13,98125,26864,71261
321474,2085,2023-02-04,23360,51275,-27915
180969,5158,2023-08-22,20878,70540,-49662
259412,2982,2022-08-28,71000,61412,9588
378937,4574,2023-04-09,10760,26343,-15583
180439,8357,2022-06-21,17638,12423,5215
282417,1082,2022-06-29,57565,3111,54454
710722,1497,2024-06-09,66695,4698,61997
800665,8987,2021-11-16,64665,5144,59521
314994,8343,2022-12-31,69030,64302,4728
946366,9060,2021-12-12,76723,55338,21385
885458,9951,2023-08-27,58680,81085,-22405
871050,5386,2022-06-30,53592,90241,-36649
922776,5336,2023-01-30,67934,16803,51131
782734,1213,2021-10-27,68491,32192,36299
461115,1176,2021-11-11,15179,94288,-79109
807298,9901,2024-06-25,73413,24462,48951
431111,9910,2023-05-01,51057,41647,9410
373429,3291,2023-01-31,34506,11276,23230
223220,4198,2023-07-26,92800,36445,56355
724574,5079,2022-03-17,9611,90035,-80424
277909,8992,2023-05-19,87878,96107,-8229
497871,5770,2024-03-23,71231,3627,67604
490224,8576,2023-05-18,52841,4393,48448
742464,7330,2023-11-10,55865,46390,9475
158801,8036,2023-08-14,72455,63333,9122
872265,1735,2021-11-19,92470,25970,66500
558647,1768,2023-08-15,94899,58896,36003
113930,5288,2024-08-21,59328,65100,-5772
872582,6318,2024-07-08,75781,22537,53244
366217,4177,2023-08-06,77638,49244,28394
438207,4059,2023-02-26,38197,54561,-16364
506558,1308,2023-10-29,96445,33815,62630
852430,9644,2022-04-21,13891,98279,-84388
547293,2049,2022-03-04,44865,81886,-37021
579343,1227,2023-05-17,92672,6403,86269
851549,4539,2022-08-26,4514,87081,-82567
718527,9841,2023-10-23,79676,98236,-18560
448625,7470,2022-05-25,51503,33153,18350
508178,1497,2021-12-16,65121,89249,-24128
656489,8691,2024-05-05,68999,96688,-27689
257419,9309,2021-12-09,22810,13548,9262
810126,6149,2022-09-30,55285,49456,5829
456191,9865,2023-06-07,13486,93926,-80440
119317,5126,2021-11-23,45351,17564,27787
551156,1176,2024-01-04,21230,25052,-3822
854901,6284,2023-09-24,14506,9647,4859
249945,7022,2022-11-08,25491,25239,252
788980,8358,2023-04-25,57280,40353,16927
371838,9023,2022-03-27,97595,30815,66780
703912,8166,2022-05-30,29429,15365,14064
432965,2672,2024-07-01,70293,82550,-12257
564896,5575,2024-02-10,22114,4324,17790
314517,1833,2022-12-22,87712,26267,61445
342588,6735,2023-06-10,19127,20799,-1672
526224,3411,2022-09-27,7726,65098,-57372
625073,2230,2021-10-25,93766,96269,-2503
320757,4261,2022-12-02,94469,34503,59966
286546,7530,2023-06-12,1112,41371,-40259
925318,8425,2022-05-18,61327,69022,-7695
378588,6023,2023-12-24,46780,55178,-8398
699719,9474,2023-04-25,69599,32974,36625
254809,6083,2022-07-18,12822,58000,-45178
943361,4689,2023-03-22,47956,42669,5287
489591,1176,2024-06-02,84444,1927,82517
149577,6379,2023-10-12,78838,45827,33011
359306,2105,2022-10-25,86937,90083,-3146
460918,9713,2022-02-22,3647,58057,-54410
259064,9474,2024-01-17,23195,9004,14191
445621,8999,2024-06-26,24677,66497,-41820
967130,8267,2023-09-24,39574,20382,19192
677056,4363,2023-10-14,73586,87395,-13809
703513,2288,2022-10-09,15153,18592,-3439
379364,4461,2022-08-12,52657,41055,11602
686201,8999,2021-10-24,71338,63554,7784
574515,8037,2023-08-21,94603,25574,69029
681085,8358,2021-11-19,21210,23851,-2641
956977,4676,2023-11-29,3281,40278,-36997
803620,3050,2024-07-27,24677,30270,-5593
845723,1496,2022-11-29,99534,66308,33226
585500,5941,2021-09-30,45499,55929,-10430
207514,5941,2022-04-10,94595,72474,22121
846731,7223,2024-09-12,25340,32317,-6977
958508,3559,2024-06-02,72911,30068,42843
461716,1351,2024-04-23,13089,12143,946
271928,7095,2022-01-02,49578,33350,16228
926051,1302,2024-03-01,43816,41542,2274
323498,4432,2024-08-14,69314,70353,-1039
123701,9951,2024-08-12,77142,4552,72590
252665,4606,2023-06-15,88578,74906,13672
139571,8469,2022-09-04,45371,97984,-52613
218636,1768,2023-06-22,72176,57606,14570
576312,3267,2023-03-21,34456,43782,-9326
585184,7838,2023-08-07,29971,84727,-54756
501103,3411,2023-08-18,58056,61339,-3283
786381,1194,2022-04-17,18035,49519,-31484
197007,2476,2022-07-23,99206,86625,12581
238682,4367,2022-11-05,13771,54945,-41174
870526,1785,2023-07-22,7531,30465,-22934
321251,4107,2022-03-21,20584,79281,-58697
381850,5632,2024-03-24,75747,88701,-12954
411346,5157,2022-06-17,70238,81564,-11326
351531,3461,2023-09-22,84746,4941,79805
240491,9731,2022-06-23,95114,19143,75971
307287,2556,2024-03-26,1520,62826,-61306
117065,9910,2021-10-24,59781,80834,-21053
477220,2288,2022-12-11,58945,59122,-177
450053,7530,2024-01-05,33537,41680,-8143
245709,4726,2022-05-05,30292,99620,-69328
600230,8702,2022-06-29,62706,17456,45250
404193,4198,2021-11-07,90747,42271,48476
869305,8989,2022-06-26,44443,8971,35472
586735,6917,2024-09-14,82223,82625,-402
614739,5575,2022-06-19,39963,18825,21138
175349,5626,2022-04-03,79106,99421,-20315
120904,5386,2024-06-09,46743,34596,12147
416108,9841,2023-06-17,70836,51723,19113
657595,4363,2023-09-10,64890,7448,57442
624919,8218,2023-07-13,81286,38336,42950
508367,9317,2021-10-01,25260,65020,-39760
661470,9322,2024-08-01,77114,4658,72456
831829,2611,2023-12-13,77532,88248,-10716
676089,9910,2023-11-08,80860,73409,7451
739698,6379,2024-03-24,87645,61575,26070
988845,6319,2022-01-13,27298,81455,-54157
330400,8037,2021-12-25,36958,70027,-33069
780453,7401,2022-03-30,70443,16755,53688
372794,6115,2023-03-05,17593,55005,-37412
631806,6726,2021-12-06,10388,90451,-80063
693120,9470,2022-02-07,5739,5874,-135
397931,2193,2022-11-10,83888,30117,53771
554416,6880,2024-08-20,99691,24311,75380
567999,8351,2022-08-11,63410,35274,28136
268036,4237,2023-10-24,70766,91660,-20894
928154,8925,2022-09-04,60289,30805,29484
989361,8989,2024-04-09,78122,69370,8752
361110,8773,2022-12-08,49288,66395,-17107
886495,4272,2023-12-06,65831,43744,22087
792233,3194,2023-05-27,83425,6971,76454
559978,1537,2024-09-07,33951,56535,-22584
522127,3498,2022-07-31,15286,12180,3106
711265,9474,2023-04-26,64016,68188,-4172
163385,2011,2022-03-13,55946,65605,-9659
754986,9295,2024-06-07,89577,88609,968
960353,3692,2021-12-21,28249,56948,-28699
462825,4367,2022-11-20,46459,19120,27339
346768,5171,2022-08-25,71967,55861,16106
237746,1250,2023-04-23,89659,87624,2035
381501,7330,2024-01-17,9788,71756,-61968
345246,2901,2024-09-11,6095,41121,-35026
201173,9255,2023-07-02,97172,70410,26762
757375,5894,2021-12-16,15774,19159,-3385
753452,7901,2023-04-26,62978,29606,33372
529804,9042,2024-05-28,30920,46499,-15579
977141,8905,2023-06-30,5000,47449,-42449
186226,3453,2022-11-07,44609,56013,-11404
900957,9672,2023-02-02,21693,11670,10023
117930,1213,2024-02-10,1153,83993,-82840
760426,6379,2022-02-04,9565,67949,-58384
989909,1497,2021-11-26,2939,41430,-38491
289858,3108,2024-09-08,30637,62224,-31587
806625,2192,2022-06-23,52190,74034,-21844
365476,3712,2023-03-09,62267,23120,39147
604665,4798,2022-04-21,35597,19828,15769
275798,1165,2022-07-03,11237,84582,-73345
155608,5597,2022-03-26,95172,27913,67259
772880,6115,2023-01-23,4486,38254,-33768
869271,9596,2023-01-16,15925,99895,-83970
445064,5749,2022-08-05,20598,72043,-51445
185983,5990,2024-02-22,33054,88154,-55100
810231,4241,2024-07-31,79801,85071,-5270
516564,4309,2023-05-16,94913,88626,6287
584278,8460,2023-12-03,55677,60230,-4553
556428,2011,2022-02-15,27518,54488,-26970
712546,6115,2022-04-11,21699,83387,-61688
623595,3721,2022-06-10,56595,73305,-16710
169284,3267,2024-08-09,51568,50593,975
167770,2074,2024-06-02,75786,24743,51043
837285,6663,2022-07-24,18853,35230,-16377
646593,1869,2023-07-28,21639,39983,-18344
561161,5249,2023-05-07,19265,59063,-39798
577328,5459,2022-10-28,46580,22494,24086
795230,4369,2024-07-07,53339,73590,-20251
121607,9255,2023-06-14,72895,38285,34610
233047,8036,2024-02-29,34886,73586,-38700
932509,1082,2024-08-28,94349,61144,33205
516804,6080,2024-05-14,10752,20937,-10185
373145,2733,2022-11-12,95230,1455,93775
545373,2476,2021-12-01,33940,29051,4889
465414,8702,2023-12-20,30227,93125,-62898
593603,5814,2023-06-16,12342,19004,-6662
491407,2640,2022-09-13,65331,86329,-20998
516707,8989,2022-06-13,84286,74402,9884
536497,7072,2023-04-22,25063,99439,-74376
416583,2556,2023-06-02,68480,39769,28711
754615,5319,2022-01-25,14660,89626,-74966
660279,6318,2022-12-30,31133,78977,-47844
727969,9322,2024-01-04,56200,37371,18829
681989,6347,2024-04-27,87631,41532,46099
235690,9818,2021-11-05,16963,63838,-46875
926905,2476,2023-12-07,20689,78308,-57619
218450,9478,2022-12-15,70443,59484,10959
695662,6115,2023-06-24,83384,2889,80495
716012,9817,2023-02-23,93924,59137,34787
273207,6016,2021-12-25,88178,47187,40991
845599,9619,2022-07-27,74688,42552,32136
849321,2251,2024-01-13,73747,19042,54705
820494,9619,2024-06-09,60601,89997,-29396
440308,9004,2022-12-04,30798,84927,-54129
412215,2105,2023-07-03,72657,94126,-21469
467590,1386,2023-06-01,18524,60600,-42076
106746,8516,2022-02-24,96776,51295,45481
966855,2139,2022-03-27,16515,52349,-35834
894445,4237,2024-06-08,7770,72278,-64508
778084,5941,2024-09-22,29448,80433,-50985
942111,2450,2022-11-15,66139,98102,-31963
882461,6290,2024-01-10,14170,51411,-37241
354964,7732,2023-02-04,61914,90223,-28309
163131,4165,2022-06-19,44908,93623,-48715
914326,9619,2021-10-14,15548,70435,-54887
583637,9010,2021-09-26,53740,4037,49703
725023,5604,2022-11-15,71466,1033,70433
583693,3692,2021-11-23,15707,91269,-75562
986765,8773,2024-01-01,5020,97365,-92345
241081,3891,2022-08-25,96091,83550,12541
180871,3308,2022-10-11,83557,59328,24229
511763,8817,2024-04-10,33829,52759,-18930
261892,7443,2023-03-25,86618,7916,78702
914026,4735,2021-10-30,49939,33109,16830
696352,2711,2022-03-13,20231,93422,-73191
744113,4567,2023-12-01,28976,75605,-46629
358414,9327,2024-07-15,94119,37772,56347
162053,7395,2022-01-04,11111,8067,3044
878694,8513,2024-05-06,97075,76653,20422
401535,4369,2024-05-03,61748,5885,55863
583378,4574,2024-06-22,33276,46911,-13635
750324,2398,2023-01-06,90252,18568,71684
623627,9672,2022-04-07,81310,4076,77234
857423,4399,2022-06-24,18823,70927,-52104
942030,4567,2022-04-20,46236,43145,3091
455614,1496,2022-07-01,30923,82895,-51972
713869,4432,2024-07-06,19893,98788,-78895
483962,2579,2022-06-11,42176,11721,30455
631298,7204,2024-08-09,5353,45686,-40333
223526,3222,2022-02-09,82500,10903,71597
897367,3050,2024-07-25,79941,25423,54518
700973,6726,2023-12-04,88173,25797,62376
905796,1250,2022-02-25,50572,63540,-12968
375016,5247,2024-06-23,37556,4826,32730
234720,5853,2021-12-31,89871,39607,50264
147409,1179,2023-10-25,91649,91056,593
527456,2426,2023-09-30,86565,19645,66920
622421,4165,2023-04-23,91484,54695,36789
665093,4198,2023-11-12,51202,63580,-12378
787810,4461,2023-09-29,48164,90885,-42721
271410,5336,2023-07-01,17546,41630,-24084
746689,5328,2023-08-14,95357,90113,5244
999345,9225,2023-08-27,17740,41145,-23405
382124,2688,2024-01-30,10392,37977,-27585
898718,5171,2022-02-12,57973,96409,-38436
868639,8725,2022-12-19,68590,84933,-16343
452699,7174,2023-08-26,26850,2596,24254
130554,9441,2023-03-15,88146,86452,1694
734899,7395,2022-07-21,77452,67195,10257
733818,2579,2022-10-19,61704,19105,42599
733858,1165,2022-04-11,29263,44493,-15230
649566,1250,2023-08-05,36177,9525,26652
848849,7036,2023-01-18,97436,23427,74009
355511,4208,2023-01-12,38955,35943,3012
385187,1008,2024-05-18,27713,8834,18879
584979,7152,2022-08-15,7353,89556,-82203
792075,2929,2024-07-05,36086,8332,27754
755343,9225,2022-03-27,71498,62011,9487
714515,5817,2024-05-23,9927,50351,-40424
199615,3703,2023-04-24,5330,42136,-36806
784210,5974,2023-07-22,58399,59554,-1155
115246,2213,2024-04-18,2508,23443,-20935
602387,4595,2023-08-21,99331,65140,34191
921351,5817,2021-12-21,73694,92629,-18935
629493,3461,2024-02-21,97024,37298,59726
865730,4703,2023-01-01,29103,57266,-28163
254149,5478,2023-12-27,84836,70045,14791
822436,5288,2022-05-28,86970,12245,74725
791237,7264,2022-07-07,74446,33359,41087
448988,4676,2023-03-16,63146,82846,-19700
571953,4780,2023-11-12,80568,15171,65397
807569,9474,2023-11-24,24767,43087,-18320
918867,5484,2023-12-12,29444,61528,-32084
504920,6324,2022-03-09,50925,36664,14261
378510,2556,2023-05-15,89325,48185,41140
485966,2074,2024-05-05,52404,1559,50845
904405,5966,2023-12-08,53946,17717,36229
465459,4224,2021-11-28,52605,64886,-12281
226707,3572,2022-05-13,41161,10657,30504
978267,9255,2022-01-20,97190,59640,37550
708293,3222,2023-06-10,94362,13091,81271
814960,9538,2023-12-04,87191,64695,22496
539846,8622,2022-09-21,28701,25614,3087
610004,3292,2024-01-29,61359,95473,-34114
551088,5965,2022-07-16,53658,34216,19442
735467,4811,2022-06-20,73575,56713,16862
472915,2011,2023-05-06,55384,30881,24503
805075,1785,2023-06-05,45014,51009,-5995
520475,5770,2022-11-18,55409,75578,-20169
521449,8800,2024-06-04,94257,99986,-5729
226619,7395,2024-05-19,68355,46476,21879
861125,7680,2023-06-25,39178,88590,-49412
737407,2217,2023-04-30,79518,63711,15807
181849,1448,2022-06-16,59199,9615,49584
581000,2785,2022-09-06,11089,49897,-38808
772007,1341,2022-02-20,45506,16003,29503
499546,4127,2024-08-20,56895,39641,17254
101517,1926,2021-10-14,19886,82473,-62587
915243,7510,2022-12-30,95717,86921,8796
578102,7443,2022-01-06,90926,12247,78679
576103,5319,2022-08-14,89350,8829,80521
715518,5685,2023-02-26,33235,93413,-60178
517685,2251,2022-02-16,34946,15988,18958
999548,5990,2024-09-22,3032,89055,-86023
868113,9082,2021-10-04,12179,67084,-54905
916426,3776,2022-05-25,70150,15553,54597
492284,2355,2023-04-05,40347,99474,-59127
141234,8622,2022-07-03,25211,54513,-29302
908283,5180,2023-01-12,36186,52565,-16379
294304,2579,2023-05-14,40455,59268,-18813
582975,1179,2023-08-20,17626,32691,-15065
859024,1504,2021-11-25,56806,63106,-6300
810771,1461,2021-10-04,50148,60265,-10117
871224,6284,2024-05-06,77404,38940,38464
671456,6663,2024-08-28,91212,43601,47611
118031,9817,2023-08-27,57903,37304,20599
652841,2398,2023-12-03,65079,14745,50334
797025,2939,2024-07-06,61336,58938,2398
883167,4399,2022-12-15,58622,85065,-26443
296065,7395,2021-11-27,23120,49400,-26280
105072,8226,2021-12-07,19245,70005,-50760
828126,5464,2023-01-26,61582,46884,14698
391026,9295,2022-05-13,1876,79729,-77853
783780,7732,2023-10-01,87766,16647,71119
669051,1496,2023-03-02,55502,18622,36880
654382,3319,2022-03-08,74689,68699,5990
799309,9255,2023-06-27,13604,14179,-575
731021,5597,2021-11-12,20541,58288,-37747
571889,9007,2024-09-10,7279,60677,-53398
583790,6690,2024-03-30,66671,80881,-14210
757891,4399,2023-12-16,37476,65260,-27784
640762,7662,2022-07-17,23711,90142,-66431
650439,2011,2022-01-03,34116,4151,29965
935583,8218,2024-02-21,68354,61621,6733
392641,9535,2023-06-03,20317,8105,12212
797615,5484,2023-10-11,33119,96416,-63297
707907,2330,2023-08-15,13673,98965,-85292
235917,4461,2022-03-06,16426,6520,9906
441227,3828,2023-08-10,48742,19326,29416
650603,5336,2021-12-06,28525,38976,-10451
423124,1016,2021-11-10,2977,30593,-27616
864299,6691,2024-03-29,98457,11492,86965
773384,2139,2022-11-30,80926,58882,22044
675531,7415,2024-08-23,44840,5717,39123
818260,5079,2022-10-28,27624,97017,-69393
217495,4663,2023-12-30,11291,33828,-22537
188474,5019,2022-04-20,92350,91689,661
879611,6361,2023-11-01,44298,19064,25234
308907,8319,2022-08-24,70793,58449,12344
501756,2288,2023-04-07,41178,94098,-52920
143795,8037,2023-03-15,65625,77232,-11607
980733,1008,2024-04-06,77327,80322,-2995
128474,1954,2024-09-19,73754,87613,-13859
981034,2330,2021-10-05,28206,89539,-61333
376206,7838,2022-10-10,18195,20038,-1843
160206,2672,2022-09-07,8554,65377,-56823
288748,9951,2023-06-30,98154,75057,23097
211916,4574,2023-08-14,83852,2212,81640
811068,9694,2024-01-05,5084,43995,-38911
141730,5525,2024-08-28,40612,14085,26527
823472,8989,2022-08-13,49416,27908,21508
508768,6969,2022-06-29,55898,77605,-21707
798714,5604,2023-05-20,12802,96266,-83464
128667,3264,2023-11-14,83848,41555,42293
253289,9248,2024-09-15,44617,39920,4697
140764,4177,2024-09-24,5390,7586,-2196
889992,3308,2023-02-01,44254,31383,12871
818142,5966,2023-07-18,57975,82489,-24514
150680,3461,2022-11-10,77013,87733,-10720
700084,3703,2022-04-24,97356,41222,56134
469602,9327,2023-01-27,91215,22756,68459
679889,6821,2023-08-31,12594,11335,1259
238440,4896,2023-03-25,56880,65901,-9021
733813,8905,2022-04-30,5390,5796,-406
526933,9787,2022-05-14,71244,32824,38420
657560,1644,2024-08-01,71428,42535,28893
319909,5336,2024-02-13,55301,33783,21518
884319,9317,2022-09-28,57741,10620,47121
746695,2857,2024-09-02,12641,2625,10016
863957,7290,2022-01-30,50507,76539,-26032
568135,1118,2022-05-02,45155,42555,2600
834409,4699,2024-05-15,2284,69523,-67239
467541,5597,2022-12-24,53207,33128,20079
909733,2089,2022-07-08,58365,40507,17858
294728,7917,2023-03-05,22189,53378,-31189
453424,4243,2022-12-06,4226,57831,-53605
542783,4309,2022-10-25,64385,75654,-11269
695889,8702,2024-06-27,14787,50167,-35380
257695,4100,2022-12-16,91576,56853,34723
891114,5705,2023-05-23,16956,70260,-53304
751289,5957,2022-03-26,39167,94020,-54853
947535,9865,2024-01-22,8746,90999,-82253
726825,9719,2024-08-21,21540,34991,-13451
766367,6917,2024-02-23,73756,21361,52395
166942,5785,2023-01-08,78145,12832,65313
765274,2821,2021-10-30,19953,1865,18088
769851,5126,2024-08-02,25370,16063,9307
543433,2640,2024-02-27,31821,69199,-37378
576853,8992,2023-05-30,98505,72761,25744
372219,9007,2023-11-05,99237,47014,52223
233385,5785,2021-11-05,99412,55475,43937
350743,3559,2022-09-11,55400,76380,-20980
516528,5770,2023-08-17,53371,2367,51004
899546,3934,2022-10-23,2483,15519,-13036
467128,2215,2023-11-20,77256,48786,28470
667702,1227,2022-05-29,79345,69813,9532
457059,5965,2023-03-08,50652,25525,25127
381853,9042,2024-06-17,92600,78165,14435
515769,8350,2022-10-25,96996,79673,17323
934627,9042,2023-01-04,12728,94851,-82123
366857,1173,2022-03-26,67997,94954,-26957
414718,8576,2024-06-30,69761,43868,25893
391116,8905,2022-04-30,47921,39397,8524
763694,2355,2024-06-21,42226,41783,443
796113,3851,2022-10-18,47825,31025,16800
450168,9951,2021-11-30,65872,48514,17358
853172,9317,2022-05-28,46891,61238,-14347
739830,1566,2022-06-16,22834,84059,-61225
190807,1977,2023-04-27,18681,19697,-1016
666497,8166,2022-11-14,38661,30009,8652
856601,4780,2022-11-05,28542,69178,-40636
305363,3791,2022-02-24,44293,66638,-22345
921235,4703,2023-08-28,46887,82245,-35358
808141,3022,2022-01-14,13425,54591,-41166
131884,1977,2024-07-07,44728,64908,-20180
909428,1833,2024-02-20,90833,56793,34040
243363,8051,2022-02-03,39315,49618,-10303
908765,7810,2023-05-27,69168,14863,54305
570989,7443,2023-08-21,88381,13633,74748
235743,4663,2024-07-22,73483,62030,11453
697094,8976,2023-01-04,3787,44414,-40627
856990,1103,2024-06-30,31165,89445,-58280
509435,9478,2024-03-16,62562,59402,3160
624315,9317,2022-08-21,67182,75049,-7867
482785,2857,2022-10-21,79653,94446,-14793
736017,8166,2023-04-29,22679,77514,-54835
355495,5604,2024-04-17,45915,99753,-53838
552674,4532,2024-04-12,72894,30367,42527
505657,8051,2023-10-12,49103,89446,-40343
893884,9535,2022-04-25,12251,52050,-39799
672817,8953,2022-11-05,10856,88799,-77943
157618,6347,2024-06-07,44507,37432,7075
883468,9322,2021-11-27,2046,30309,-28263
617672,1227,2022-11-19,26547,12476,14071
834235,4597,2022-10-31,63410,40166,23244
840087,5007,2024-03-30,36611,10746,25865
951551,7917,2023-07-15,60384,96434,-36050
872151,6149,2023-10-07,46764,29216,17548
365922,8817,2023-10-02,66707,2313,64394
221530,6880,2022-05-23,2505,32692,-30187
210801,9309,2024-01-24,54761,87631,-32870
431601,1396,2021-11-18,7507,96773,-89266
454605,7223,2023-06-18,11852,76209,-64357
823662,2105,2024-06-16,64307,16651,47656
949380,8976,2022-01-29,30159,59664,-29505
736637,5427,2022-03-16,45798,94865,-49067
573993,4699,2024-08-13,17786,16266,1520
961658,8218,2022-04-07,59670,36835,22835
934157,2857,2022-12-21,74450,70685,3765
695229,1173,2023-02-05,11260,72976,-61716
176799,6023,2023-05-22,73141,95934,-22793
564180,4478,2024-09-02,36607,57310,-20703
102344,3721,2023-10-12,19977,79268,-59291
553783,2745,2022-10-11,83130,58971,24159
389665,2692,2023-11-15,85052,12570,72482
408407,1179,2024-09-03,75851,9823,66028
878874,3498,2021-10-20,76783,13195,63588
412890,9223,2022-01-31,84570,74529,10041
314994,5330,2023-02-11,65694,90214,-24520
597004,4224,2023-12-15,36430,21565,14865
402552,9865,2022-05-11,60695,12355,48340
700709,4346,2023-04-22,78094,43128,34966
490296,1807,2022-07-14,63004,46268,16736
278911,2579,2024-04-19,24131,65473,-41342
494259,5770,2023-10-14,46346,66284,-19938
142162,1948,2022-09-18,3854,33000,-29146
971713,5817,2022-11-25,28112,6066,22046
271964,8358,2023-08-28,47958,30730,17228
297987,1376,2024-06-11,87056,75449,11607
563726,2193,2022-01-12,90972,68761,22211
865033,7510,2024-01-16,47327,19764,27563
940432,2688,2023-06-14,37504,70032,-32528
774472,2611,2024-07-11,20188,56283,-36095
728410,3791,2021-12-04,59979,56085,3894
349163,6347,2023-11-20,82127,15222,66905
374066,9644,2022-03-05,29634,50554,-20920
107295,8740,2022-08-17,94660,40453,54207
994290,2579,2024-06-10,6327,46596,-40269
602368,8218,2021-12-02,60920,19112,41808
744007,6965,2023-12-09,5448,17970,-12522
998596,1553,2024-06-17,26347,92197,-65850
884128,2623,2021-12-12,10637,82544,-71907
921205,4567,2022-04-25,79618,91626,-12008
755984,2901,2024-08-01,9894,13708,-3814
174033,3821,2023-12-03,8617,26790,-18173
585272,8797,2023-12-19,89302,71450,17852
760592,2863,2023-07-01,44049,27891,16158
885465,7670,2022-09-26,66233,15753,50480
390537,4689,2023-11-07,12774,57498,-44724
283851,1386,2022-07-11,37616,51529,-13913
732163,8051,2022-01-13,26860,39125,-12265
180550,6726,2024-05-06,64672,68111,-3439
868007,6452,2023-01-13,91591,9107,82484
336456,2611,2021-10-23,1769,30385,-28616
491154,7732,2024-02-10,95723,67796,27927
582946,3712,2021-10-21,97755,47897,49858
552479,4091,2022-04-09,79675,3914,75761
338382,1553,2022-12-18,10955,30930,-19975
656479,3144,2022-02-28,5907,1894,4013
492399,4309,2024-07-03,79739,8052,71687
856910,5894,2024-06-16,70234,25962,44272
569416,6563,2024-06-20,57501,79120,-21619
766440,1461,2022-08-30,12456,61693,-49237
853730,4595,2023-03-19,43204,33494,9710
683843,5385,2024-02-06,80587,76852,3735
195789,1302,2022-06-16,40222,9934,30288
100930,8351,2023-02-13,25461,22458,3003
162211,2640,2023-02-24,30008,73431,-43423
851098,4363,2022-07-15,22786,14872,7914
137361,8800,2022-10-10,8083,78839,-70756
881988,1977,2024-04-16,2662,59681,-57019
698814,4689,2024-03-15,5729,64861,-59132
734050,4999,2022-08-04,1363,24888,-23525
199905,6937,2022-03-01,99536,99787,-251
620694,1216,2021-11-29,69601,41641,27960
929971,3776,2021-10-04,2709,16463,-13754
686474,7204,2023-10-17,17652,31755,-14103
491222,2821,2022-04-17,60127,18239,41888
868988,6476,2024-03-25,18115,44501,-26386
372204,7838,2023-09-16,33426,65389,-31963
835463,1644,2022-09-03,69721,31341,38380
826643,9197,2023-10-14,70436,43035,27401
799014,7415,2022-08-23,4247,12603,-8356
737987,4086,2024-04-27,58349,40453,17896
405915,7470,2022-03-12,38322,32845,5477
949956,8516,2023-05-09,18880,66233,-47353
949828,9353,2022-07-15,56707,97707,-41000
417017,6539,2024-06-04,74081,70459,3622
519902,8267,2021-09-30,99875,41487,58388
548917,2450,2021-12-13,37769,75104,-37335
854643,5330,2023-01-24,79584,5697,73887
773771,4595,2024-02-28,21112,58303,-37191
909055,2745,2022-07-22,81831,51449,30382
942097,4100,2021-10-11,55526,49811,5715
809526,2192,2022-03-02,14163,78266,-64103
483710,8218,2022-10-25,45824,32373,13451
820006,1103,2022-03-09,56065,81912,-25847
725546,8343,2022-08-10,41669,45028,-3359
578700,2984,2023-06-21,86948,39740,47208
354658,2640,2024-03-04,35716,44150,-8434
348506,1496,2023-05-03,22241,96031,-73790
327093,6726,2022-03-19,53971,52423,1548
983213,2692,2024-03-02,19265,18232,1033
172921,4939,2022-11-06,99994,84939,15055
553157,1566,2023-12-04,13104,94263,-81159
203946,2450,2024-06-18,67940,66729,1211
659897,3776,2024-09-13,33326,7098,26228
743343,1537,2024-08-15,78173,43037,35136
471158,1376,2022-04-26,24354,81684,-57330
570047,5007,2024-06-07,25827,61583,-35756
749616,8425,2022-12-30,26510,4138,22372
594749,3498,2021-11-21,49515,6637,42878
140096,6917,2023-07-05,40043,45826,-5783
533228,2863,2022-11-15,84682,18792,65890
298969,9223,2024-09-13,20917,86006,-65089
646080,5068,2023-07-11,39191,86358,-47167
733425,6205,2023-07-08,44921,63665,-18744
806220,2217,2022-05-11,82018,98414,-16396
237329,7036,2024-01-13,10639,21501,-10862
942779,9865,2021-10-15,74508,78127,-3619
461918,4309,2022-01-19,59079,35657,23422
712521,6361,2022-12-09,91717,89598,2119
369309,4999,2023-10-10,5110,11575,-6465
476564,1341,2021-11-24,87889,65283,22606
736580,9116,2023-12-19,33545,54064,-20519
520172,7120,2023-09-18,28564,82534,-53970
639143,5427,2023-07-30,23876,47658,-23782
628764,4780,2023-07-21,81171,44901,36270
391246,5957,2022-07-31,73799,91483,-17684
713282,1351,2023-02-19,36252,60876,-24624
395507,9915,2024-02-24,17957,19621,-1664
584313,4261,2023-10-28,91692,35200,56492
570070,1651,2024-04-05,20807,2639,18168
724697,4367,2021-10-19,59635,68735,-9100
807177,7209,2023-08-06,71409,16837,54572
438956,6541,2023-12-03,64588,75751,-11163
681944,7166,2022-08-30,70683,84904,-14221
322275,1103,2022-01-05,64910,47441,17469
810382,7510,2024-01-01,68728,93203,-24475
124548,4461,2022-04-29,56715,41658,15057
520599,5157,2023-03-14,1756,62511,-60755
457191,6880,2022-01-15,9001,51417,-42416
787362,7917,2022-06-29,65364,38852,26512
542495,7635,2022-10-11,73899,80769,-6870
958902,2398,2022-09-25,34783,34266,517
372339,8218,2023-12-22,57305,51881,5424
133253,6319,2023-02-04,50418,66478,-16060
782251,8350,2022-12-23,88453,58659,29794
565202,4947,2024-03-31,26081,25859,222
343118,3194,2021-12-15,13643,60307,-46664
504878,8036,2024-01-17,36330,97237,-60907
989939,9132,2023-06-23,28618,27298,1320
635298,4086,2024-09-02,93602,13017,80585
932145,4539,2023-05-20,89778,39214,50564
205299,9399,2023-11-17,92286,67775,24511
202726,6685,2023-12-05,60382,10871,49511
112196,6361,2023-01-11,48668,75210,-26542
164220,8319,2024-05-28,60228,99083,-38855
616146,5071,2024-09-01,43359,16060,27299
392809,3144,2024-02-05,13789,5154,8635
588488,4100,2021-10-06,18017,25300,-7283
807682,4532,2024-04-28,87283,17855,69428
226418,9910,2023-10-25,26095,51401,-25306
754607,3712,2022-01-22,49075,80349,-31274
382876,9082,2021-12-29,31305,87959,-56654
970653,2929,2022-09-23,37874,1238,36636
483142,8138,2022-11-20,23416,75014,-51598
700794,3411,2023-04-08,48867,37643,11224
800145,8011,2023-08-21,60508,57244,3264
685141,3326,2023-02-13,92222,41508,50714
573824,8469,2023-09-15,45856,76957,-31101
431776,7680,2023-02-26,28932,10684,18248
670768,5966,2022-08-03,45014,62829,-17815
488341,4127,2023-05-14,68185,30872,37313
897004,8968,2021-11-22,10636,60364,-49728
191147,2774,2024-08-23,94379,74903,19476
238532,4950,2021-12-29,27864,8433,19431
686787,9941,2024-09-15,59414,27234,32180
503910,2902,2024-08-22,22571,87075,-64504
967954,8011,2023-11-28,44790,95404,-50614
677651,9951,2023-06-17,11516,33042,-21526
239330,2991,2022-07-20,38695,37812,883
411852,3559,2023-04-17,87116,81477,5639
126763,7008,2023-11-04,3136,89270,-86134
996337,3040,2022-07-16,84154,89409,-5255
430647,5916,2023-02-14,11451,70143,-58692
385967,9255,2021-09-28,7443,91045,-83602
347640,2901,2024-05-21,37916,52686,-14770
376752,8319,2021-11-05,99348,35868,63480
949174,5770,2023-08-28,42688,5241,37447
887288,4539,2022-05-04,91443,65155,26288
559236,5990,2021-12-28,88698,25776,62922
343956,6965,2023-10-06,78689,34159,44530
849240,7670,2023-02-02,59300,23467,35833
597122,8582,2022-11-17,80050,44465,35585
457315,1807,2023-05-24,18920,15519,3401
561743,1165,2023-03-25,44201,91109,-46908
696010,1104,2022-02-04,75709,75135,574
179715,5957,2024-05-28,55178,86531,-31353
725614,4968,2023-03-27,66579,11335,55244
224373,6352,2024-01-06,45790,84570,-38780
511804,7732,2022-06-05,16469,63184,-46715
789218,9804,2024-05-14,80490,91616,-11126
263177,6563,2023-06-23,14245,52101,-37856
604518,2085,2023-09-02,69938,71392,-1454
623722,2230,2023-07-13,30223,98121,-67898
518479,6149,2022-02-16,65037,46837,18200
584676,8662,2024-01-10,59070,67441,-8371
867391,1520,2023-01-17,27510,68646,-41136
253996,2939,2024-08-17,43979,93109,-49130
113194,3319,2022-07-09,33178,53916,-20738
183676,6318,2024-08-03,9361,22118,-12757
439984,9478,2021-09-29,63169,97368,-34199
243539,8351,2024-07-20,56272,95402,-39130
252545,5288,2024-05-20,3130,89148,-86018
722294,4606,2023-05-30,29426,11664,17762
414335,7014,2023-03-26,17266,92187,-74921
687646,6016,2023-03-20,32473,26173,6300
660711,2450,2023-08-14,82786,29752,53034
287414,5894,2024-05-17,93368,14657,78711
718699,3308,2023-12-23,17653,66843,-49190
920875,8905,2023-02-16,48300,45031,3269
147839,2013,2021-10-10,18806,24705,-5899
991642,4461,2024-02-09,51521,7095,44426
192134,7011,2023-05-18,4062,49968,-45906
388188,2623,2022-12-12,36296,17384,18912
851027,9060,2024-08-21,41250,18312,22938
456871,2857,2022-03-02,46258,37239,9019
290804,4091,2023-08-06,87887,87673,214
789264,9474,2024-05-19,13250,82112,-68862
998940,5004,2023-12-19,39237,98957,-59720
578674,9197,2022-07-16,31714,44730,-13016
456678,8350,2023-05-26,96677,75036,21641
938120,5004,2024-07-04,38590,16503,22087
420248,5894,2022-10-06,88120,90758,-2638
164354,3712,2022-02-07,13146,28191,-15045
794465,7231,2022-12-24,80629,42763,37866
191508,8030,2023-01-24,98857,67690,31167
814384,1785,2022-10-18,21810,28498,-6688
596671,8030,2021-10-28,45613,94793,-49180
960237,9713,2023-11-05,26705,9527,17178
233369,4127,2022-08-04,86581,37702,48879
587638,5427,2023-02-26,99992,9692,90300
553182,6663,2022-02-25,90209,81396,8813
601304,8905,2023-05-15,88736,68038,20698
449764,2330,2024-06-18,88321,85331,2990
453982,7917,2021-10-14,67335,91341,-24006
345402,8999,2024-04-27,16066,82858,-66792
130168,4574,2023-10-07,39907,19793,20114
403214,1473,2023-06-18,28539,91772,-63233
540597,9010,2023-01-18,52014,9749,42265
759028,8358,2023-11-19,76756,31457,45299
704682,1869,2022-03-14,32971,76056,-43085
968172,7303,2021-12-17,84476,39492,44984
736113,4699,2022-11-15,30578,39848,-9270
602394,5785,2023-12-29,99198,50892,48306
853385,2692,2024-08-07,96621,9672,86949
548768,6115,2022-01-02,90560,7082,83478
953308,1833,2022-02-26,80094,9338,70756
961150,1947,2024-02-26,93101,49641,43460
472069,4432,2024-09-04,7165,9580,-2415
493066,9478,2022-02-16,22120,17532,4588
457918,7662,2022-09-01,3466,50375,-46909
420427,9470,2022-12-26,67033,52442,14591
297832,3030,2024-04-13,26723,30333,-3610
614038,9012,2023-04-28,54807,14083,40724
718966,6361,2022-04-14,69743,88280,-18537
828072,1808,2023-07-20,67997,80556,-12559
723409,1461,2022-03-29,78216,14415,63801
425161,7786,2024-01-22,22506,69812,-47306
885174,8860,2022-11-15,25840,20532,5308
233179,8218,2024-06-26,50671,88210,-37539
615152,2426,2022-04-20,54823,26217,28606
455520,7152,2023-06-12,87150,18783,68367
428755,4272,2024-03-06,60454,65660,-5206
878124,9713,2022-02-09,95249,61414,33835
663886,7330,2021-12-22,65640,75371,-9731
881865,7911,2022-02-18,83588,93146,-9558
305423,9596,2023-03-16,55745,58674,-2929
532901,4086,2022-09-24,65209,3653,61556
959488,3714,2021-12-14,76283,35957,40326
270170,1473,2021-10-04,50892,67865,-16973
296309,3292,2022-02-03,22644,88386,-65742
534597,5079,2023-12-07,14354,31089,-16735
933416,8343,2023-07-29,38671,56921,-18250
587721,4227,2022-11-29,98521,86610,11911
329391,1954,2024-04-02,64399,51402,12997
490052,4208,2023-01-23,83183,4462,78721
164814,9023,2021-12-07,8304,73666,-65362
641666,4367,2021-11-11,62423,92715,-30292
362250,2785,2024-05-08,6874,10015,-3141
272144,8817,2022-07-11,82450,86539,-4089
752102,2940,2022-11-01,72376,80103,-7727
566511,8989,2024-05-28,9851,50889,-41038
953951,2821,2023-10-28,50306,28368,21938
208032,3051,2021-10-22,13233,38376,-25143
202815,9672,2021-10-10,79222,17822,61400
145098,6150,2024-03-06,51634,53380,-1746
277226,8925,2023-12-22,23205,85170,-61965
714734,2857,2022-12-01,66490,36007,30483
656870,4532,2023-04-23,89290,14414,74876
315839,1396,2023-10-18,34648,43693,-9045
147608,8622,2021-10-01,94588,17863,76725
568929,7510,2024-08-07,80139,94744,-14605
575543,2251,2023-10-14,17169,72393,-55224
802642,7395,2021-10-10,38736,7106,31630
217281,7223,2023-07-24,65957,77421,-11464
386468,5894,2023-10-23,5950,24543,-18593
161426,2929,2023-04-21,42876,17671,25205
981063,1479,2022-12-23,87646,30646,57000
808658,3461,2024-06-18,64127,17235,46892
559505,8968,2023-08-04,93500,74452,19048
291401,8358,2024-08-18,34366,31914,2452
502195,4461,2023-01-21,14170,89112,-74942
171891,5319,2024-09-06,72406,51425,20981
451710,8442,2023-09-29,71158,95495,-24337
225183,5171,2023-07-05,26565,47425,-20860
799669,9694,2024-02-21,74975,10199,64776
397812,1496,2024-09-16,11026,13453,-2427
916910,5916,2022-12-29,78834,83005,-4171
180770,6280,2024-06-13,68200,78817,-10617
642395,6023,2023-11-15,32077,31985,92
524614,5478,2024-01-01,36274,18027,18247
897626,8130,2022-06-12,46383,31129,15254
552108,5889,2022-08-28,1173,54900,-53727
213861,1208,2023-12-11,93938,52918,41020
704106,1208,2021-12-27,96582,34002,62580
688346,7174,2021-12-14,39937,7091,32846
426559,1553,2024-01-20,19592,8385,11207
777084,2972,2022-02-09,93095,3007,90088
576734,8999,2024-09-12,94631,56528,38103
522362,9619,2022-07-23,41086,8665,32421
257875,6347,2023-12-25,16997,56037,-39040
371864,8905,2022-09-29,83048,97904,-14856
767190,1977,2021-10-20,79742,51664,28078
334652,7022,2021-10-24,44334,95159,-50825
876055,4574,2022-11-11,16647,83238,-66591
398682,8976,2022-01-25,20218,26014,-5796
348179,9619,2021-11-25,83630,96694,-13064
211376,7132,2023-01-17,53861,26726,27135
953578,6023,2022-07-18,99995,91718,8277
369974,1448,2023-05-10,46181,54229,-8048
576242,8925,2024-07-05,44235,32413,11822
807072,4597,2024-07-23,10892,69732,-58840
705865,3072,2023-04-10,46960,74375,-27415
735822,7911,2022-04-26,80080,13700,66380
163334,1448,2021-10-26,32527,76906,-44379
356061,3023,2023-11-26,52102,4190,47912
370854,1461,2023-11-17,87332,95775,-8443
125698,9619,2023-05-26,49272,95633,-46361
134476,1869,2021-10-12,86287,59632,26655
829581,1479,2023-07-26,7040,27735,-20695
125663,6452,2023-09-28,37556,55740,-18184
250709,1869,2022-02-28,28323,34633,-6310
232639,3319,2024-03-03,64205,88449,-24244
885554,4663,2021-11-13,20034,17298,2736
259777,1977,2023-10-13,82802,52019,30783
794378,5459,2023-08-31,50812,69990,-19178
363013,1847,2022-03-31,70714,18851,51863
142218,3264,2022-06-11,43550,94746,-51196
451030,6280,2023-01-08,20207,28384,-8177
480034,5192,2023-04-19,76254,93605,-17351
652012,9309,2022-11-16,59442,45127,14315
712616,7470,2021-10-05,76650,20018,56632
181760,4689,2022-01-24,90412,92426,-2014
846198,1473,2024-04-15,17479,19129,-1650
946300,7264,2023-08-15,92869,42738,50131
173271,1082,2024-06-25,6746,7789,-1043
234710,5966,2023-04-05,75638,51562,24076
127826,4227,2023-12-27,97372,76280,21092
685820,2640,2021-11-02,78741,86998,-8257
230273,3559,2024-06-02,39478,95349,-55871
828977,8469,2023-07-31,72741,63618,9123
446838,1103,2023-03-09,65419,21156,44263
196212,4567,2024-08-30,46574,65528,-18954
915381,9644,2022-12-29,71229,44939,26290
845406,1082,2022-11-02,95937,17000,78937
830691,8968,2024-02-18,78991,95556,-16565
509558,1148,2022-03-04,12252,79422,-67170
785007,3934,2023-11-27,42776,71160,-28384
867582,5240,2023-10-25,93189,24603,68586
431284,9981,2023-11-16,44439,91987,-47548
861214,7790,2023-07-08,77702,92338,-14636
699245,9901,2023-08-20,33562,11170,22392
226512,4107,2021-12-02,44633,1626,43007
122053,5249,2023-05-25,98212,74482,23730
673003,4432,2022-03-09,20221,40436,-20215
905148,9012,2022-01-27,50481,17676,32805
664045,3222,2022-06-19,84105,46053,38052
497159,3572,2022-04-05,68707,74936,-6229
597501,6880,2022-11-09,81650,41938,39712
567648,3887,2023-10-11,79121,48527,30594
258301,8030,2024-02-11,92244,26657,65587
810387,1194,2023-10-19,63683,14078,49605
571024,1954,2022-03-28,28989,43679,-14690
875566,1351,2023-11-24,30199,71427,-41228
106674,7359,2024-07-01,11442,36687,-25245
976771,4717,2024-04-24,32156,24099,8057
503243,9474,2022-06-29,65610,68817,-3207
737292,8460,2023-07-27,39344,58964,-19620
786989,1341,2024-08-26,59391,79610,-20219
406894,6319,2023-06-02,40966,23538,17428
726522,9943,2023-02-22,85980,24210,61770
811959,1479,2022-09-20,92419,17531,74888
104508,3291,2022-03-31,17635,23433,-5798
465828,5319,2024-06-27,98290,82296,15994
327393,7132,2022-02-25,84376,97621,-13245
916819,4726,2023-10-27,15184,34130,-18946
679728,9255,2022-02-17,59879,98507,-38628
679556,4999,2022-01-12,1200,32582,-31382
719281,1644,2022-04-18,51019,47869,3150
410495,6965,2022-10-02,40292,38366,1926
604878,7567,2023-09-25,68135,93727,-25592
895689,8319,2022-01-23,66040,71362,-5322
978672,5386,2021-12-20,77080,95571,-18491
572435,5459,2022-03-03,23526,58095,-34569
460630,5382,2023-09-03,35846,18120,17726
280878,1926,2022-01-21,21573,82034,-60461
841878,8905,2024-08-12,65329,82440,-17111
788651,1497,2022-05-01,38500,73088,-34588
397999,8343,2022-08-10,46122,19735,26387
299665,5685,2023-04-23,3511,10699,-7188
371107,8817,2024-02-25,27070,63157,-36087
831739,5685,2022-01-17,86301,8787,77514
386383,2579,2021-10-10,56479,26853,29626
234734,6115,2023-04-01,7761,76882,-69121
516956,9042,2023-01-11,82122,86833,-4711
832157,8800,2022-04-14,74007,68460,5547
812846,2426,2024-04-14,95568,19819,75749
178252,8576,2023-10-28,59500,29357,30143
241450,3460,2023-01-13,88662,48083,40579
714801,4699,2023-01-07,22451,99358,-76907
398502,5966,2023-04-02,68567,42549,26018
619014,7209,2022-09-19,6404,20547,-14143
341514,3450,2023-07-29,5063,95227,-90164
225788,4245,2023-03-01,93593,74967,18626
522783,5288,2021-11-11,89780,58259,31521
740524,6150,2023-09-30,80510,99504,-18994
363123,2939,2022-11-04,24086,98750,-74664
630692,5007,2023-03-01,95074,96705,-1631
666959,6016,2023-10-14,62717,67788,-5071
252748,1008,2022-09-12,99901,81957,17944
706522,4165,2024-09-18,15965,69388,-53423
520601,5240,2023-07-30,34437,41041,-6604
207048,3461,2024-03-28,24104,85777,-61673
393802,6690,2023-11-14,17084,57787,-40703
879076,4100,2023-09-10,77274,23620,53654
490951,7303,2022-08-03,77767,46383,31384
122957,9910,2024-04-15,20493,8991,11502
843160,1808,2023-02-16,67153,10541,56612
874125,1948,2022-03-10,24685,87435,-62750
800722,5974,2024-08-08,78830,17742,61088
648029,9441,2023-08-13,9201,5642,3559
148335,5019,2021-12-02,51277,42784,8493
780558,7132,2024-07-27,18648,8211,10437
687102,7662,2023-05-05,46448,91273,-44825
652125,9248,2023-12-07,92150,23326,68824
771434,2139,2024-06-28,61803,88252,-26449
498303,9255,2023-11-17,38258,63848,-25590
779941,4689,2022-08-12,55179,57821,-2642
968055,8817,2021-11-23,12450,43940,-31490
475461,5889,2024-02-24,61113,89689,-28576
882163,1473,2022-11-07,22950,70234,-47284
247461,8817,2023-07-04,52173,32072,20101
899569,5330,2022-08-13,51191,22508,28683
295024,2869,2023-02-02,74169,63226,10943
462592,8026,2024-07-02,83460,59906,23554
369944,6735,2021-11-15,9755,1597,8158
906987,4532,2023-05-21,97485,77185,20300
114406,3326,2022-10-10,71404,77102,-5698
576272,8800,2023-07-03,75360,98140,-22780
817046,4399,2024-04-17,36397,59975,-23578
179277,8797,2022-02-27,7670,62263,-54593
585228,2579,2023-10-27,31673,31520,153
332301,1882,2022-06-10,62300,76557,-14257
946483,2193,2023-10-19,60239,1067,59172
922887,2672,2024-06-23,56699,33048,23651
478403,4399,2023-04-07,7318,24237,-16919
186963,8036,2022-12-03,49542,38187,11355
718260,7011,2023-06-20,32629,40815,-8186
883802,2408,2023-01-04,19562,98903,-79341
621990,1208,2021-11-29,70465,75159,-4694
420112,8976,2024-05-05,33585,55226,-21641
430527,8513,2021-11-30,81237,19472,61765
378504,3851,2023-04-13,34824,77119,-42295
254402,4086,2023-09-24,16900,18296,-1396
908442,4606,2022-10-21,33041,5812,27229
104550,6735,2023-12-05,61382,61620,-238
288067,7786,2023-09-10,80066,12326,67740
203756,6917,2024-04-13,35004,86800,-51796
680189,4947,2024-04-18,26192,35003,-8811
527031,2450,2022-03-02,76984,49937,27047
919859,4399,2022-12-28,88618,1464,87154
359695,9042,2023-06-24,82227,28209,54018
625947,8026,2024-05-23,80834,7929,72905
713069,5478,2022-06-26,44369,88655,-44286
683804,5957,2023-11-12,11058,85852,-74794
636344,1902,2023-09-21,17026,96926,-79900
793717,4900,2021-10-16,1090,27045,-25955
977026,5192,2022-10-21,79134,65062,14072
602927,7470,2023-02-15,41172,23067,18105
527797,9327,2022-04-03,48086,71110,-23024
635432,8576,2023-01-18,30112,38662,-8550
112110,5575,2024-07-18,1410,7363,-5953
936984,5288,2024-05-17,47634,50357,-2723
310466,3264,2023-02-06,69383,16590,52793
620314,8905,2023-12-29,92119,9949,82170
719665,5966,2021-12-12,45049,40950,4099
682510,6726,2024-08-21,45493,67678,-22185
624321,1537,2022-11-05,98307,13808,84499
328914,2213,2022-01-11,87286,30098,57188
843243,4947,2022-03-16,15592,92973,-77381
180131,3194,2022-10-22,20167,8051,12116
880018,2288,2022-07-09,68318,48915,19403
921136,9225,2024-05-25,90574,12834,77740
461973,6290,2022-07-04,15554,58028,-42474
524034,2011,2023-08-01,49776,54068,-4292
535968,1947,2024-03-13,59156,12260,46896
660193,8350,2022-06-21,24217,3885,20332
367401,2074,2024-01-30,75504,67641,7863
522495,8343,2022-06-24,73392,91028,-17636
368351,4532,2023-02-19,10140,97051,-86911
406341,3222,2022-05-24,50900,39089,11811
444740,9082,2023-08-26,95994,54927,41067
591067,3015,2024-09-05,88548,89975,-1427
899340,8357,2022-04-17,12347,35849,-23502
607217,8721,2022-12-27,80781,2796,77985
243460,7810,2023-12-28,85214,20714,64500
457067,5126,2023-12-24,49837,37174,12663
810989,1227,2021-11-02,61552,24268,37284
575790,1435,2024-02-27,41007,95634,-54627
696824,9309,2022-03-04,19610,21090,-1480
869205,3267,2022-05-04,26912,21967,4945
148722,5268,2022-01-27,94807,22104,72703
517237,3559,2022-02-17,59254,14359,44895
571577,7395,2023-10-03,48494,40708,7786
901219,9207,2023-12-06,4000,58194,-54194
524600,5158,2023-03-21,26419,95338,-68919
198547,6690,2023-09-29,11245,87734,-76489
193036,3460,2022-11-13,72342,64477,7865
100819,1768,2022-01-08,65618,63568,2050
878879,2821,2024-08-02,25522,69629,-44107
106720,6759,2024-02-15,32149,18032,14117
189098,5330,2024-04-30,66904,66111,793
361018,3714,2024-09-11,50249,4431,45818
615985,2139,2021-11-06,33216,62264,-29048
597584,5685,2021-10-15,15421,57494,-42073
759505,7401,2024-05-25,70618,69681,937
556794,2863,2022-05-27,51679,29917,21762
222605,5953,2023-02-08,41145,40413,732
643805,4261,2022-06-30,39012,63750,-24738
967770,6685,2024-02-10,59801,46432,13369
104230,8576,2024-02-17,85024,63395,21629
293707,1386,2021-12-24,50700,10078,40622
971810,9474,2024-08-10,78931,9902,69029
507176,3887,2023-05-10,27290,34449,-7159
526401,1926,2024-08-03,97216,78728,18488
948615,5097,2022-04-25,29749,62941,-33192
977147,3326,2023-11-12,79781,77786,1995
330116,9901,2023-03-21,26813,70253,-43440
931147,9055,2023-07-04,42886,27005,15881
547423,7290,2023-07-07,73796,59609,14187
438168,6691,2024-03-17,12109,37546,-25437
400262,9004,2022-03-03,1299,24412,-23113
156727,7942,2023-06-15,64526,83277,-18751
788518,8999,2023-06-22,2643,22458,-19815
290372,5180,2022-07-20,50584,22472,28112
698878,4363,2023-04-20,18646,74339,-55693
733298,4237,2023-06-01,60539,1120,59419
528049,9197,2022-12-15,62651,28759,33892
713074,1118,2022-05-28,42639,83577,-40938
269021,8442,2023-11-27,50077,78046,-27969
819232,6965,2024-07-08,41134,69291,-28157
616663,7454,2022-05-13,24260,83702,-59442
448131,5814,2024-03-14,72115,62288,9827
644813,9309,2022-03-14,20694,43932,-23238
447091,8905,2021-10-26,12159,30524,-18365
527153,8166,2021-12-31,32376,94597,-62221
124758,3453,2024-06-24,97113,41743,55370
638597,6115,2023-08-28,47674,45359,2315
325128,5322,2024-05-02,91878,18503,73375
115737,3108,2024-03-10,79210,30873,48337
639246,3319,2023-12-09,34754,59680,-24926
166874,7036,2024-05-16,26441,46471,-20030
786898,1497,2024-06-28,22593,78925,-56332
859673,8647,2024-05-14,14756,76263,-61507
909147,4245,2023-01-27,72183,77069,-4886
446433,8925,2024-06-05,52616,99914,-47298
260569,5817,2022-01-16,18283,89550,-71267
632910,8905,2021-12-19,53614,80619,-27005
677725,5249,2023-05-24,50312,29901,20411
577798,8702,2022-09-20,65395,2843,62552
760665,3319,2024-07-08,23043,19264,3779
554302,8425,2022-11-04,64870,52570,12300
501962,5882,2023-07-19,89929,56864,33065
764431,8725,2024-04-21,68204,9679,58525
150379,4703,2023-07-22,20548,73731,-53183
997336,3887,2024-06-21,51440,42194,9246
577601,6324,2024-02-08,77354,89949,-12595
298481,5068,2024-08-19,3565,39920,-36355
945152,1504,2022-07-28,42173,94027,-51854
799880,4241,2024-05-28,35845,46240,-10395
702915,8622,2024-02-01,90510,99400,-8890
402644,7415,2022-08-04,75135,40382,34753
298776,5988,2023-01-14,52819,76123,-23304
363017,8051,2022-06-12,45075,71428,-26353
965594,4900,2022-06-15,99275,79514,19761
524353,1341,2023-08-21,15901,49247,-33346
500403,9865,2022-05-25,27890,9703,18187
282905,6080,2024-01-03,37360,45622,-8262
107784,8970,2022-09-01,88739,37383,51356
667148,1497,2023-04-23,25119,11025,14094
417922,8992,2023-12-18,57673,11485,46188
425010,3194,2024-06-12,67266,13213,54053
500996,1767,2021-10-22,79939,89700,-9761
262863,6663,2022-07-31,82912,7605,75307
720863,6280,2022-10-21,16539,43364,-26825
410694,1768,2023-03-07,68773,49518,19255
684811,4432,2022-03-16,48532,19075,29457
112951,9442,2024-04-10,64762,60888,3874
675323,6452,2022-06-05,34173,97167,-62994
253856,5592,2024-04-10,53720,88254,-34534
716154,4059,2023-03-20,45009,43649,1360
911786,4091,2023-08-23,9480,90491,-81011
650510,9399,2023-01-15,17968,25574,-7606
429595,4574,2023-08-08,89883,62189,27694
804175,4539,2023-06-29,9635,4934,4701
973147,2193,2023-03-08,5143,72110,-66967
427145,2857,2023-09-30,69306,48730,20576
711612,8905,2022-05-21,44346,80830,-36484
825211,1435,2021-11-06,49254,33966,15288
771325,7818,2023-07-18,91020,67571,23449
273214,6663,2024-01-31,58380,90277,-31897
618093,9719,2024-07-06,1316,74749,-73433
246223,3326,2021-09-28,21458,41487,-20029
689460,3308,2023-06-14,40521,68423,-27902
844759,6347,2022-01-17,8570,40254,-31684
162526,9619,2022-12-27,88651,23550,65101
953877,3023,2024-03-29,8352,82710,-74358
447771,5974,2023-05-08,9767,51862,-42095
449890,2176,2024-08-24,38995,77717,-38722
800190,1473,2024-05-26,89854,90977,-1123
609037,6347,2024-03-06,65940,97610,-31670
289381,1847,2022-10-24,73256,29901,43355
855583,2688,2023-11-16,51601,55608,-4007
921770,1735,2022-09-24,63532,85968,-22436
371955,2711,2024-03-28,98630,47463,51167
873039,2982,2024-08-20,89696,66558,23138
220525,4227,2023-06-15,36436,54620,-18184
818751,9910,2021-12-06,89183,56006,33177
491257,3887,2022-02-11,52180,26286,25894
404831,3292,2021-12-22,59836,23052,36784
637879,6083,2022-02-23,68269,79343,-11074
856277,5328,2023-10-03,71128,47784,23344
936959,6149,2023-09-15,66794,11694,55100
446404,8110,2023-11-30,10372,31595,-21223
561656,7008,2022-05-31,46318,25746,20572
941844,9470,2023-07-19,7326,33709,-26383
418289,5974,2024-04-01,40343,87234,-46891
370102,6726,2023-02-14,43557,82374,-38817
815030,5713,2022-07-16,66320,82339,-16019
680404,1497,2023-12-27,75079,80326,-5247
127580,7072,2022-01-29,74592,92932,-18340
883172,2745,2022-07-11,56598,52688,3910
614953,2869,2023-02-24,55214,78608,-23394
227466,2940,2022-06-02,61951,66461,-4510
340706,1833,2024-05-29,54878,98480,-43602
113630,8989,2023-02-09,28073,15386,12687
287168,3015,2024-08-27,8271,63163,-54892
697122,9004,2023-05-07,89571,50675,38896
230841,8218,2022-09-06,74842,77509,-2667
602438,8987,2023-05-02,19644,57510,-37866
297762,2105,2023-12-18,33939,61534,-27595
102964,2901,2023-12-29,17641,14825,2816
201309,2176,2024-04-01,99281,84580,14701
570181,4399,2023-03-11,13195,87697,-74502
567307,7359,2024-09-21,29429,97436,-68007
647415,6937,2022-01-17,17472,29230,-11758
187396,7256,2024-04-13,49139,70393,-21254
714848,7415,2022-01-27,48409,98871,-50462
981723,4597,2023-04-09,8598,61589,-52991
494569,1977,2023-10-27,73389,47727,25662
584535,2711,2024-05-30,19878,99242,-79364
111241,8516,2022-05-25,32908,19666,13242
291832,5126,2023-04-13,55754,13345,42409
516085,2192,2023-01-29,94708,94975,-267
442610,3023,2024-06-05,51175,21766,29409
221385,5889,2023-04-11,39743,23312,16431
842894,5097,2021-10-10,26650,33356,-6706
205377,7165,2024-04-16,94597,90828,3769
329174,3194,2023-07-01,5306,41378,-36072
241481,5004,2023-06-10,99229,67650,31579
606807,3572,2022-10-29,44492,62894,-18402
842196,6691,2022-04-13,66128,56529,9599
750232,2640,2024-06-25,20392,84844,-64452
711407,9004,2023-11-18,82996,1860,81136
486226,8953,2021-10-03,83798,73467,10331
123974,3791,2021-11-13,46651,49620,-2969
890292,2476,2023-12-19,38998,61833,-22835
185879,8702,2021-10-25,19813,78114,-58301
288796,2355,2023-07-10,39020,40153,-1133
509544,5814,2024-07-21,37190,8459,28731
666959,7225,2021-09-25,99082,38363,60719
235381,4272,2022-06-03,31732,29755,1977
834013,1250,2022-07-02,87285,56266,31019
745717,4002,2022-12-16,4594,68299,-63705
787953,3851,2023-03-04,33243,37640,-4397
751110,5459,2022-08-11,47648,9401,38247
977777,8860,2024-06-21,3978,41280,-37302
760577,7225,2023-08-23,15034,91780,-76746
567766,7256,2023-02-03,47673,43696,3977
450190,3291,2024-09-02,96815,45952,50863
345475,3411,2023-01-14,41944,77411,-35467
770520,5126,2024-07-01,13416,8331,5085
753981,8647,2024-02-24,42445,35660,6785
591015,6726,2023-02-27,49445,31068,18377
920481,1644,2021-10-30,78188,77515,673
920757,8721,2021-11-22,36029,41321,-5292
433795,1808,2022-10-14,11687,7055,4632
273521,1208,2023-11-14,58951,19247,39704
285743,9644,2022-05-21,9767,72966,-63199
281267,2194,2022-08-19,87112,28264,58848
292947,4478,2023-09-10,15077,51435,-36358
425630,7501,2022-02-22,48598,14783,33815
955318,5007,2024-04-17,46803,78377,-31574
828604,9818,2023-07-31,99214,34609,64605
847585,5632,2022-12-20,20973,16146,4827
476049,6917,2022-05-23,17021,8273,8748
610279,9865,2022-06-01,13092,18820,-5728
907648,1750,2024-06-05,50077,94955,-44878
890457,4539,2022-04-03,93292,91754,1538
296005,3222,2024-04-14,1645,84132,-82487
783139,6115,2022-05-25,30781,55958,-25177
738911,7263,2021-11-05,45455,28870,16585
769481,8460,2023-04-16,29744,78436,-48692
627584,4968,2023-09-13,34107,30157,3950
151910,5597,2023-04-29,48352,19256,29096
383705,7303,2022-07-09,29024,99576,-70552
952621,5749,2024-05-12,50729,35497,15232
909591,8462,2022-04-26,59825,83425,-23600
764549,7680,2024-05-14,47617,77982,-30365
279437,8051,2022-03-30,30527,10229,20298
905505,8516,2022-09-18,25621,45197,-19576
389821,2972,2024-05-10,39209,54157,-14948
495603,3319,2022-11-16,7993,30917,-22924
306574,8968,2023-04-17,85251,33477,51774
186377,6347,2023-06-14,9698,90564,-80866
645554,4947,2024-08-21,70070,40872,29198
130338,6541,2023-03-31,72690,68373,4317
408829,9010,2023-12-08,52887,42256,10631
198407,9981,2022-05-21,70586,96696,-26110
987292,3891,2024-09-10,75304,11918,63386
252104,5525,2023-11-05,17270,68864,-51594
477751,5386,2022-05-24,11857,6848,5009
640660,7014,2023-01-28,92578,91940,638
898548,9478,2023-05-07,26801,52974,-26173
302391,2774,2024-09-13,96768,8384,88384
377978,8691,2023-08-27,2658,78058,-75400
468439,3319,2024-06-15,25210,50024,-24814
360564,3572,2022-03-20,86103,65323,20780
879701,1566,2022-04-27,48743,50772,-2029
610569,4939,2023-08-05,81699,42620,39079
912747,5749,2023-09-06,37398,68753,-31355
683894,4084,2024-09-07,70460,76540,-6080
560664,2045,2021-09-26,46829,42525,4304
877529,3194,2023-05-25,14200,74951,-60751
989662,2937,2022-07-15,59949,22750,37199
555988,4227,2023-01-06,71502,14487,57015
942511,8740,2024-01-12,53793,48608,5185
503169,6880,2024-01-05,19113,57431,-38318
994607,5882,2023-10-31,51873,3434,48439
250772,9128,2022-11-27,95467,89777,5690
982262,3712,2024-01-26,26697,15545,11152
412026,4369,2024-02-04,9475,72231,-62756
904849,8992,2022-10-31,23089,80011,-56922
424905,9981,2024-08-26,45695,74469,-28774
994671,9128,2024-01-20,34446,51224,-16778
664250,3934,2022-04-30,65417,32855,32562
451175,7454,2023-08-13,13167,57032,-43865
826878,3572,2023-07-08,24421,32025,-7604
729331,4532,2023-06-14,62341,96308,-33967
145425,6083,2024-06-08,11802,64230,-52428
882659,1948,2024-06-20,21360,17469,3891
210221,3887,2022-01-25,75597,24681,50916
301393,7256,2022-07-03,43841,96837,-52996
337083,6290,2024-04-15,56627,98497,-41870
674036,6229,2022-06-18,69245,26536,42709
120858,8516,2023-12-11,79235,14667,64568
227998,7401,2023-10-30,74158,77178,-3020
564492,1448,2023-04-23,72139,93866,-21727
284530,9353,2022-05-09,59414,68615,-9201
161804,8037,2023-02-25,7773,40712,-32939
426996,5808,2022-03-31,65278,39660,25618
200129,1179,2022-03-21,7852,3742,4110
676242,2139,2023-07-27,76118,36232,39886
744579,8622,2023-08-09,8924,39017,-30093
531547,8030,2022-09-07,16325,58178,-41853
470573,4999,2022-12-05,81865,17887,63978
277144,9951,2023-02-17,39862,82957,-43095
540573,8462,2022-11-23,56855,50364,6491
380086,1768,2023-09-23,93828,18993,74835
508210,5604,2022-12-02,44049,52823,-8774
969327,9225,2024-09-13,10723,26022,-15299
181921,8351,2023-05-28,32695,68360,-35665
926118,7152,2023-03-02,16491,1845,14646
376386,5597,2022-05-10,35092,3843,31249
819865,1947,2023-10-18,74122,41025,33097
984264,4165,2022-10-03,89995,36823,53172
580645,7470,2024-02-08,43699,37388,6311
713466,4100,2023-05-16,88420,85397,3023
478631,4939,2024-04-10,81042,70080,10962
960395,4059,2023-04-24,14336,28837,-14501
848301,9197,2024-04-11,8717,44902,-36185
315610,1302,2021-12-30,40148,75615,-35467
595462,9981,2023-08-21,45910,76258,-30348
194407,8725,2022-07-22,15951,72195,-56244
780481,6115,2022-10-06,20134,13215,6919
557404,4689,2023-10-13,3090,51778,-48688
589748,6937,2021-10-01,45568,90551,-44983
222753,9943,2022-08-09,4654,33097,-28443
722970,4597,2023-12-24,26333,81396,-55063
221124,4478,2021-12-06,8202,65265,-57063
547152,1082,2023-10-04,21668,3619,18049
741258,5957,2021-10-01,46482,30667,15815
236715,2217,2022-11-16,78108,50271,27837
450254,9865,2021-11-23,15539,56978,-41439
897463,2089,2023-04-14,30138,94171,-64033
219669,5019,2023-05-30,97025,43838,53187
250368,7680,2023-06-12,50438,66093,-15655
483026,3264,2023-03-28,18777,38596,-19819
107168,5180,2023-05-11,42998,42528,470
753733,5336,2022-03-18,27902,4665,23237
423237,2288,2023-03-14,31841,18754,13087
247579,5268,2023-12-05,95633,99018,-3385
514769,5626,2023-06-12,28178,1435,26743
590549,9197,2023-01-30,64765,69500,-4735
528049,6880,2023-05-29,53612,70212,-16600
597661,9132,2023-05-11,84447,85659,-1212
610086,4461,2022-01-14,19475,28900,-9425
665829,5626,2024-08-28,88508,93930,-5422
465795,4896,2022-01-11,6377,28988,-22611
463916,2857,2022-12-23,84702,20194,64508
413649,7401,2022-06-22,64503,41595,22908
899281,4798,2023-06-19,54130,97823,-43693
734000,8442,2023-02-12,66891,3498,63393
444649,5916,2023-06-27,64607,79093,-14486
873502,5974,2023-09-17,10220,52988,-42768
462725,9399,2023-11-03,76476,25636,50840
431363,9128,2024-09-08,85857,48556,37301
564585,7022,2022-07-13,21638,71163,-49525
137240,1461,2023-06-25,66522,59706,6816
605709,6726,2023-07-04,66739,20306,46433
447189,4780,2022-08-02,32012,54758,-22746
674883,5330,2021-11-15,22095,58013,-35918
433199,6290,2023-05-04,78984,27914,51070
847893,1308,2022-08-29,44411,47778,-3367
974375,1902,2023-06-22,67588,56150,11438
975995,5966,2023-05-26,98969,22484,76485
141189,2868,2023-04-20,72311,56655,15656
559924,1376,2022-06-19,87867,88188,-321
345307,9060,2024-06-14,76837,10305,66532
930816,5126,2022-09-07,59534,98697,-39163
786266,1063,2022-05-30,97709,58606,39103
752852,1651,2022-06-18,7024,83916,-76892
532995,9901,2024-05-31,14093,10171,3922
214517,1118,2024-02-23,42654,61737,-19083
182174,2579,2022-05-06,73929,18808,55121
493293,5007,2024-07-27,19011,71344,-52333
739786,5685,2023-02-09,79102,27043,52059
495868,6880,2024-07-14,45397,75469,-30072
976524,8051,2023-05-10,34062,35341,-1279
101400,3692,2023-03-25,25491,14869,10622
772272,2672,2023-12-01,85329,7717,77612
970551,4896,2022-08-02,6258,5434,824
877159,3319,2022-09-12,54898,15177,39721
898212,1847,2021-12-31,64784,63488,1296
311175,2450,2023-06-16,27325,46009,-18684
214439,4595,2023-12-26,89159,46834,42325
150788,7898,2023-12-02,94296,75338,18958
410451,2611,2024-06-08,59586,77116,-17530
544642,2194,2024-03-05,63547,99299,-35752
606089,8691,2024-06-14,34297,88461,-54164
306920,4465,2023-09-03,62082,18690,43392
709751,2579,2024-06-02,89287,57385,31902
257037,4091,2023-08-29,12853,49206,-36353
332925,2476,2021-12-16,18527,44548,-26021
390462,4703,2023-07-20,37846,72919,-35073
288759,3572,2023-03-14,67200,36091,31109
467625,5330,2023-09-08,77134,6068,71066
775767,9007,2023-07-11,34618,74239,-39621
468130,1902,2023-12-12,61999,56556,5443
440219,5322,2021-10-29,60353,74162,-13809
255018,7165,2023-08-20,15099,9781,5318
565696,1063,2023-07-27,69318,37304,32014
737744,1566,2022-01-01,46527,53051,-6524
435540,4532,2022-03-14,6210,92119,-85909
439198,3368,2021-10-10,70161,72046,-1885
249991,4780,2024-03-11,80068,14066,66002
477117,1250,2024-04-12,84949,18515,66434
287709,3144,2022-09-13,70816,5405,65411
832893,5322,2022-10-05,55599,51758,3841
136374,1520,2024-06-19,59047,23156,35891
244086,4465,2024-05-29,40601,38848,1753
593970,5749,2023-05-18,85850,29869,55981
874295,3264,2023-08-23,15542,6969,8573
625612,4717,2021-11-20,19970,13284,6686
951466,8051,2024-05-07,59483,48515,10968
140787,1165,2022-09-18,14361,19522,-5161
133734,1148,2024-08-14,78590,62115,16475
433797,7786,2023-09-16,26742,93008,-66266
223009,7072,2022-03-07,53426,47006,6420
918152,4245,2023-05-10,97030,39554,57476
988118,5966,2023-02-01,58931,70320,-11389
904320,4699,2023-04-05,16129,75356,-59227
515626,5386,2021-12-11,58216,85717,-27501
820497,3292,2023-07-22,4497,26706,-22209
791229,8740,2022-04-18,25290,32330,-7040
764879,1386,2023-07-02,49511,76699,-27188
164336,1302,2024-06-14,18093,14101,3992
113198,5478,2023-06-18,29759,83213,-53454
258193,6149,2023-01-22,30466,85858,-55392
336204,7209,2021-12-17,25708,63399,-37691
636857,7454,2022-12-21,83577,4831,78746
355052,1977,2023-07-30,59224,39886,19338
991257,9619,2024-04-13,84184,37005,47179
454022,8166,2022-10-16,5245,12149,-6904
826459,6821,2024-01-15,10813,11089,-276
618334,9943,2023-09-28,70817,32629,38188
268562,9082,2023-05-29,20373,65499,-45126
337643,1644,2024-01-29,8931,55644,-46713
719730,9223,2023-01-15,90806,82338,8468
264796,4127,2024-03-28,89899,71335,18564
584298,7174,2021-11-10,53895,39589,14306
482005,8011,2024-03-19,44630,23417,21213
256311,3051,2021-10-21,58870,8862,50008
981486,7072,2024-09-14,69515,41636,27879
274866,7898,2022-07-12,47672,44407,3265
660883,4663,2024-01-24,2600,80070,-77470
580076,3887,2023-10-08,31858,39520,-7662
255053,4367,2024-02-13,37224,39063,-1839
939789,5382,2022-03-11,98555,82689,15866
949975,5007,2024-03-27,46513,5442,41071
631511,3291,2024-07-03,7599,64549,-56950
860755,4241,2022-12-08,18777,48274,-29497
303996,9042,2022-05-25,59527,72444,-12917
551862,4811,2022-09-27,13888,1355,12533
809919,4272,2023-03-07,35131,64865,-29734
580238,1553,2024-08-28,46053,65932,-19879
487823,1553,2023-07-27,58035,53367,4668
100984,2556,2022-07-15,75452,37774,37678
221648,5713,2023-08-27,79387,98003,-18616
407894,9719,2023-09-10,18661,55186,-36525
680811,7008,2022-02-18,94032,90776,3256
896872,6476,2024-06-12,23285,52867,-29582
330936,4798,2022-12-24,39088,95242,-56154
742150,2972,2024-03-14,37848,22428,15420
895147,4574,2022-08-24,80659,90239,-9580
907459,2711,2021-10-22,68186,59197,8989
600292,8026,2022-04-04,77828,66979,10849
367835,3934,2024-04-06,36050,30139,5911
471783,2355,2024-04-03,75614,79106,-3492
646979,3453,2021-12-15,15416,79812,-64396
838219,6563,2024-05-07,2149,78148,-75999
108034,7670,2023-04-28,40816,5263,35553
196324,2193,2023-07-18,4479,10742,-6263
216540,5525,2023-03-11,14038,53359,-39321
788649,9309,2021-11-09,39037,13826,25211
777630,7152,2022-09-20,44088,45002,-914
533075,4461,2022-06-06,23324,74448,-51124
642194,8905,2024-07-23,29975,53852,-23877
256319,3714,2023-06-05,53633,53462,171
954204,2192,2022-12-06,19032,50919,-31887
571875,8817,2024-07-16,93041,2371,90670
743283,9327,2024-07-10,75415,67462,7953
465984,1880,2023-10-05,75588,66425,9163
706084,1869,2022-11-16,17883,20139,-2256
381766,7263,2023-09-30,72462,25255,47207
513663,8516,2024-08-07,99963,90046,9917
613157,8970,2023-05-13,65431,75047,-9616
308429,7415,2021-11-02,72393,63691,8702
828835,7680,2024-03-06,40881,70152,-29271
952636,7036,2022-07-05,69697,27961,41736
130970,3791,2023-01-06,11776,38763,-26987
794003,2011,2023-08-12,36897,83744,-46847
609651,8460,2022-01-26,22482,75111,-52629
388399,7330,2023-01-26,44996,9587,35409
807157,2049,2024-03-03,78007,47244,30763
794079,4100,2023-09-27,34944,64321,-29377
161564,1520,2022-03-28,27528,42500,-14972
732090,8051,2023-04-02,70236,87257,-17021
456808,6969,2022-10-30,74684,81277,-6593
955188,2733,2022-06-20,36752,76693,-39941
650277,6352,2021-12-12,58765,2744,56021
136614,4999,2024-02-08,37833,83226,-45393
904140,7470,2023-11-17,12412,77341,-64929
864068,4107,2024-03-17,44908,27298,17610
259665,8968,2024-02-24,48323,72981,-24658
918705,6541,2023-11-21,55071,53633,1438
709441,4241,2024-08-21,75016,24349,50667
298321,1948,2021-09-25,31531,49789,-18258
701238,4241,2022-04-23,8705,83719,-75014
448810,4574,2022-12-03,43779,89525,-45746
349153,3460,2023-02-20,81304,67228,14076
573444,8992,2022-02-12,86775,33194,53581
933265,4084,2023-08-03,40279,91040,-50761
774207,7028,2024-03-18,86577,86073,504
925208,4968,2022-01-31,6981,1444,5537
555808,2074,2023-01-05,35752,54379,-18627
163259,6324,2024-05-14,76501,56188,20313
387413,4059,2021-09-25,74751,88326,-13575
262811,2213,2023-04-10,3562,21667,-18105
373266,7204,2023-09-15,6236,20311,-14075
434898,8319,2022-08-21,82333,48822,33511
982964,5004,2024-01-25,62644,92440,-29796
479832,8925,2022-04-08,84488,49892,34596
398448,5685,2024-09-21,66172,65314,858
493762,1216,2022-06-12,63231,71882,-8651
547909,5180,2022-05-21,42463,28440,14023
200320,3267,2023-12-12,40691,76526,-35835
704570,8011,2022-11-20,27306,69619,-42313
494249,7670,2023-12-23,41494,50766,-9272
917301,9060,2023-09-26,98651,15796,82855
211020,5240,2024-08-05,45056,4937,40119
410653,3292,2023-07-28,41358,30820,10538
509774,2408,2022-08-23,61216,35316,25900
538911,8576,2022-05-22,20443,83497,-63054
827345,8622,2023-08-26,57656,7035,50621
630156,9787,2023-02-12,67856,14383,53473
140928,4717,2024-09-01,12436,55597,-43161
155893,7790,2023-11-01,37756,44816,-7060
367707,1341,2023-12-18,52017,95996,-43979
571009,1082,2024-01-23,86340,55681,30659
967592,3791,2022-06-03,68267,44212,24055
969237,4237,2023-06-12,30361,82810,-52449
816262,6688,2022-03-27,8959,14067,-5108
382934,8860,2024-08-27,45252,71155,-25903
911350,6016,2023-03-20,28324,28498,-174
134769,2085,2024-08-11,2489,16666,-14177
738106,6290,2023-08-02,52935,49159,3776
368207,7264,2022-06-04,36568,65758,-29190
930852,1396,2022-04-19,13674,58947,-45273
303797,2991,2023-10-20,58451,97011,-38560
901689,1833,2023-11-01,94515,53055,41460
939246,9535,2021-12-01,62359,23554,38805
678504,9207,2022-06-11,20028,9553,10475
711952,7011,2022-04-17,99323,60468,38855
123230,6541,2022-01-20,82709,43996,38713
389781,2640,2024-05-23,58289,13406,44883
493927,1179,2023-01-21,87372,95611,-8239
794598,3051,2022-01-23,3643,89855,-86212
768130,5986,2023-11-20,46985,97382,-50397
679627,8425,2023-05-12,63521,23388,40133
776298,2984,2023-07-31,78497,89968,-11471
593916,5464,2024-09-04,58755,71658,-12903
736307,2217,2024-03-06,57012,99886,-42874
731859,9841,2023-10-25,76992,2514,74478
885704,7072,2024-08-06,95269,56137,39132
994817,9060,2022-07-10,26687,17845,8842
625813,7917,2024-04-20,34326,71760,-37434
215861,5019,2023-12-25,7801,91129,-83328
738551,1286,2022-06-14,9199,63692,-54493
866298,3291,2023-04-24,8056,32190,-24134
603598,1785,2023-04-20,75610,40688,34922
576714,5592,2023-10-13,86786,43328,43458
328759,7790,2021-12-26,37138,81830,-44692
943609,8442,2023-10-29,28185,28837,-652
285544,8218,2023-02-18,64429,79002,-14573
823101,1435,2024-09-21,71235,6421,64814
784940,3411,2021-12-12,86023,67430,18593
441388,5626,2024-06-29,31947,57603,-25656
271913,6965,2022-10-04,37701,29632,8069
484906,5814,2021-12-31,2349,9387,-7038
117982,7510,2023-07-19,30612,94991,-64379
535202,8513,2023-05-19,80203,86978,-6775
521722,5986,2022-06-09,35577,85711,-50134
946945,2991,2024-04-15,7601,86817,-79216
504912,7225,2023-12-17,54930,7389,47541
331956,4243,2021-12-19,71413,9980,61433
330750,5330,2022-03-12,92353,83521,8832
930600,4574,2023-09-16,59349,93285,-33936
242324,9255,2022-09-23,47112,50482,-3370
327803,6969,2023-12-28,85176,7801,77375
772592,5007,2023-06-16,51240,75989,-24749
811290,8576,2023-03-24,57621,59401,-1780
308787,8773,2021-10-07,85722,43427,42295
299546,4261,2021-12-20,31314,14516,16798
711254,4245,2022-09-05,29089,59469,-30380
903768,9596,2022-02-02,22478,1098,21380
941934,2937,2023-09-23,33137,1520,31617
726034,5268,2023-07-31,71153,7953,63200
217552,7415,2023-01-02,21863,94054,-72191
469253,1768,2024-08-10,4316,53842,-49526
410147,8442,2023-11-14,56904,76100,-19196
173384,9007,2024-01-07,88174,38734,49440
452387,8166,2024-08-24,78670,71011,7659
747518,1448,2022-01-31,31722,71401,-39679
379483,5685,2022-02-26,20482,42370,-21888
313295,3326,2022-10-27,66168,71450,-5282
151109,2176,2024-06-09,44205,30579,13626
424822,2984,2022-01-13,54046,41569,12477
807421,3453,2023-03-06,60576,17511,43065
184517,4227,2023-03-28,18315,57926,-39611
904590,4798,2023-05-09,70944,72350,-1406
743184,7225,2024-05-07,5513,51197,-45684
644914,4798,2023-06-04,72772,94686,-21914
927679,2693,2022-09-18,90381,29425,60956
796956,8425,2023-07-05,12648,58631,-45983
526286,8218,2023-07-03,31365,2946,28419
871261,1566,2022-10-14,24392,78179,-53787
367052,1448,2022-02-06,79866,16294,63572
828850,4663,2022-07-28,1814,53867,-52053
986442,6290,2022-05-10,81335,95427,-14092
386723,5249,2022-12-29,13703,11984,1719
802479,5974,2023-07-05,42696,25730,16966
880450,7501,2021-11-09,36200,68379,-32179
625216,7680,2023-08-11,3354,15815,-12461
170334,4735,2022-03-23,93903,90703,3200
629718,8725,2023-04-24,92912,55742,37170
908428,9012,2024-09-16,27411,37182,-9771
968973,9435,2022-12-28,52198,84448,-32250
829208,4245,2023-10-14,78246,76200,2046
371269,5004,2022-06-30,84157,22863,61294
599112,8691,2022-07-16,19555,79627,-60072
730335,6759,2022-04-16,48547,92896,-44349
753008,7011,2023-03-03,32063,3584,28479
404110,6563,2024-07-09,92496,30287,62209
672252,7231,2024-04-01,11167,73728,-62561
687737,8343,2024-04-21,32254,3865,28389
586975,9197,2022-03-19,49942,16712,33230
121108,7917,2023-09-24,34238,31040,3198
193512,8026,2024-04-12,79849,37474,42375
110382,5798,2023-12-04,49352,44899,4453
829962,5240,2024-04-13,71977,4610,67367
109700,9941,2024-04-11,69522,73227,-3705
337305,5770,2024-09-12,96885,25590,71295
572437,4726,2022-11-14,97103,79186,17917
453930,4127,2023-10-03,39343,5739,33604
247539,2251,2021-10-07,28547,97968,-69421
722535,3821,2024-04-01,39454,95097,-55643
775658,7818,2023-10-30,22796,3266,19530
803768,4947,2023-11-07,87661,88933,-1272
484336,8460,2023-08-11,9311,70465,-61154
409260,4889,2023-09-26,1638,47746,-46108
153532,4241,2024-09-15,71573,61028,10545
379841,2217,2024-03-09,19272,95190,-75918
584352,5097,2022-12-28,79412,46685,32727
617214,9474,2022-04-09,81823,85205,-3382
111896,4597,2023-08-26,16763,59364,-42601
557475,2450,2023-08-12,27361,95594,-68233
866020,5322,2022-10-17,43790,53923,-10133
748965,1194,2023-07-08,48538,54703,-6165
722162,6937,2022-02-23,99322,75196,24126
370863,9353,2024-03-11,42107,29231,12876
185036,3712,2022-09-18,81981,41111,40870
156252,4127,2021-12-26,36344,82206,-45862
876457,4597,2023-10-11,45437,83831,-38394
536721,5817,2023-01-24,69193,61809,7384
527620,9223,2023-10-16,59625,48643,10982
757034,8483,2022-07-28,23219,7744,15475
567914,4574,2024-02-17,48874,82050,-33176
151252,5986,2022-09-30,30283,34935,-4652
222697,5079,2023-05-03,56783,13631,43152
915160,8989,2023-08-23,4182,52402,-48220
968518,2450,2024-07-17,63923,94550,-30627
410862,5817,2024-01-30,83166,12420,70746
112546,7330,2023-10-16,76993,63199,13794
963208,6229,2023-02-04,32632,66859,-34227
912429,7014,2022-07-18,23681,32679,-8998
864177,6083,2024-01-07,79289,71640,7649
625241,2193,2024-07-30,73396,9076,64320
463802,9981,2024-05-31,64250,2337,61913
762852,2774,2023-09-20,86304,76907,9397
984401,9981,2022-01-11,87452,12517,74935
243397,9981,2023-11-07,57692,68063,-10371
334825,8358,2024-09-04,65501,88831,-23330
213752,1351,2022-12-27,44283,18008,26275
358980,6080,2021-12-02,68642,29848,38794
780796,4726,2022-09-26,12820,30446,-17626
378312,9128,2022-06-06,61497,39890,21607
889739,7771,2024-07-02,66201,52269,13932
935722,5817,2023-05-22,61489,63148,-1659
570386,4798,2022-11-22,15460,3297,12163
573457,2991,2024-02-10,82841,58969,23872
620193,5814,2024-03-19,3422,57040,-53618
381267,5853,2022-05-19,49307,66263,-16956
588805,5288,2023-03-03,31181,37276,-6095
204907,9619,2022-02-09,63610,53287,10323
505659,5427,2022-08-29,8501,81389,-72888
753018,2105,2022-08-10,29348,64432,-35084
904134,6332,2024-02-29,14690,38095,-23405
175945,2940,2023-01-17,88510,68721,19789
381884,9010,2023-10-27,22299,30154,-7855
807555,4091,2024-08-13,3296,8230,-4934
693552,9474,2022-02-10,56882,67839,-10957
647056,5894,2022-10-10,36966,30897,6069
384061,4567,2023-02-25,96114,77241,18873
924729,6083,2022-11-30,78270,77728,542
856501,9538,2023-01-11,75643,77205,-1562
761954,1735,2021-12-10,48668,52575,-3907
145814,9818,2024-01-19,57323,17528,39795
171244,5894,2023-07-09,5786,70814,-65028
885651,7942,2024-04-07,2782,66084,-63302
710061,3460,2024-04-15,58518,61338,-2820
287588,5953,2022-04-29,60492,20832,39660
830967,1732,2024-04-15,98221,6454,91767
391690,6691,2022-12-07,74908,16180,58728
517770,3040,2021-12-29,9261,41270,-32009
780653,4272,2022-12-17,62571,4871,57700
547457,1148,2022-03-09,99026,74419,24607
565094,3821,2022-11-17,69278,91331,-22053
452047,2857,2023-01-05,52252,6811,45441
687492,4363,2022-07-15,68922,90785,-21863
402873,8110,2022-09-11,28578,83338,-54760
728286,7359,2024-01-31,11547,68471,-56924
697061,7838,2022-06-13,1951,91880,-89929
332289,8725,2021-11-13,3991,93697,-89706
668323,2672,2024-04-04,95673,79492,16181
295074,4567,2022-10-08,26024,29162,-3138
167210,5097,2023-09-17,57848,81583,-23735
911363,7415,2021-12-10,29766,8714,21052
162951,9309,2023-12-01,5168,99949,-94781
787649,5808,2022-10-11,77457,65164,12293
192253,2745,2021-12-11,37635,79360,-41725
806552,7072,2022-01-18,63783,86571,-22788
201740,9804,2022-06-16,33810,96986,-63176
676090,7264,2023-01-01,77043,48316,28727
810340,3368,2023-03-26,77365,40173,37192
820874,3887,2022-08-09,21042,39679,-18637
782991,6735,2024-05-05,35502,15370,20132
191602,1194,2023-11-20,17953,52853,-34900
358716,2693,2022-05-14,49848,56258,-6410
728312,9619,2021-10-02,9814,2693,7121
303780,4127,2022-08-04,59806,41596,18210
728344,6691,2023-08-15,27380,83048,-55668
491950,2556,2024-05-05,34219,10125,24094
501006,3498,2022-11-30,54610,1921,52689
811329,2139,2022-09-14,75596,40644,34952
116581,1216,2021-12-04,3984,28217,-24233
118635,5459,2022-06-21,54013,34579,19434
829939,7530,2021-11-17,3929,61448,-57519
852614,4002,2024-03-23,84776,78137,6639
272142,6965,2024-04-28,57201,25816,31385
237707,4606,2022-03-07,11757,47047,-35290
699329,7174,2024-04-25,77775,75083,2692
284753,2623,2024-02-17,20315,4415,15900
392303,6352,2021-11-18,90000,51735,38265
268287,5916,2022-02-09,28441,27588,853
810528,4597,2023-02-23,72859,88011,-15152
911653,8218,2024-04-20,7365,91529,-84164
872962,4900,2023-10-03,31913,54159,-22246
903747,8343,2023-12-30,98963,33432,65531
257769,4532,2023-02-02,43766,22515,21251
766612,6290,2024-03-28,30015,95648,-65633
471381,2869,2022-01-15,47080,52534,-5454
365522,1396,2023-08-15,64949,99051,-34102
279447,1750,2022-12-19,47090,47217,-127
397700,5986,2023-09-29,35833,47361,-11528
279084,8925,2022-04-28,25672,90007,-64335
371992,8469,2023-01-22,79986,50923,29063
185516,5713,2023-10-28,62929,90852,-27923
705226,2579,2023-12-01,26655,88562,-61907
341739,6229,2022-09-24,65321,79584,-14263
842094,6726,2023-11-18,34277,37200,-2923
754373,7008,2022-05-05,49224,6736,42488
395022,7942,2022-07-24,26337,39315,-12978
106314,9116,2023-10-21,68451,79550,-11099
514421,1750,2022-02-24,86735,5090,81645
944597,4107,2022-09-18,54902,6522,48380
924211,8030,2022-04-07,93388,1806,91582
570797,4100,2022-08-13,47976,24963,23013
436815,8797,2023-05-12,7151,69134,-61983
755999,9012,2022-11-25,16565,48563,-31998
459552,4939,2022-07-11,52550,7851,44699
421767,7204,2021-12-19,11942,75608,-63666
651734,5990,2023-01-22,22702,81850,-59148
822136,8797,2021-11-09,97726,6391,91335
987669,9023,2022-06-26,21036,13258,7778
733733,2355,2023-10-12,30761,99951,-69190
484006,9903,2023-06-11,81368,15369,65999
964199,2929,2022-10-26,1341,37951,-36610
262868,5330,2021-12-21,80840,75526,5314
910302,4735,2023-07-01,7606,51052,-43446
636010,8110,2023-08-15,44972,25736,19236
476738,2745,2023-11-17,67082,97683,-30601
854477,4532,2023-07-16,49823,71438,-21615
425369,7530,2023-04-22,95002,78383,16619
214806,9731,2022-12-01,18985,80530,-61545
147529,3144,2024-02-27,51004,85645,-34641
585048,2398,2023-08-21,82352,32641,49711
546559,7401,2023-07-02,16579,79658,-63079
925752,8358,2021-11-09,90694,66350,24344
899587,3703,2023-08-21,46583,94959,-48376
462180,9060,2023-12-30,80270,75971,4299
759468,5071,2023-12-14,34314,19081,15233
637244,4478,2023-04-22,46696,78355,-31659
209433,5385,2023-06-13,14100,86968,-72868
695547,5853,2021-10-28,8986,37432,-28446
634393,5965,2022-08-01,32223,27981,4242
234105,5749,2023-03-02,81058,65641,15417
746369,2940,2022-04-23,34465,22972,11493
152707,5785,2023-02-10,55313,92735,-37422
483337,9694,2023-05-19,78192,54734,23458
947000,8702,2022-07-03,89243,62150,27093
705539,3832,2024-09-03,97883,73408,24475
245058,3972,2024-07-07,69337,3894,65443
996740,1386,2023-12-24,6409,84225,-77816
806496,8513,2022-09-27,19223,26446,-7223
816931,2210,2023-01-13,46437,88209,-41772
707288,2733,2024-04-29,85061,98898,-13837
257253,9248,2021-10-04,7120,18509,-11389
783301,5322,2024-06-14,70697,99859,-29162
573193,4478,2024-03-27,78033,21405,56628
445206,2556,2023-05-29,18574,70156,-51582
504941,1341,2024-05-06,10902,30493,-19591
452585,4002,2022-05-15,24923,95485,-70562
760947,8051,2024-08-22,97890,3416,94474
217435,3291,2021-11-02,94207,56475,37732
132077,5484,2023-03-22,57608,73775,-16167
715533,9223,2024-01-19,27954,17907,10047
599637,5986,2022-09-24,94424,36377,58047
346404,7174,2022-10-26,55502,39204,16298
398796,9865,2023-05-26,88744,54641,34103
355417,3828,2022-05-26,45413,66212,-20799
594394,1553,2022-02-12,71500,5450,66050
251447,2217,2024-03-28,24125,11925,12200
179849,9841,2022-08-26,71616,15961,55655
838376,7942,2023-07-13,61761,10728,51033
632734,5986,2023-12-20,45959,2899,43060
264256,1947,2022-11-21,40277,52488,-12211
862994,4369,2022-09-23,39844,61927,-22083
526441,5916,2023-04-29,96397,48917,47480
238783,2105,2021-12-14,69788,59084,10704
742412,8030,2023-09-03,16860,14667,2193
921742,9672,2023-04-06,36742,22828,13914
220579,4100,2023-07-30,4531,59389,-54858
446225,9804,2022-12-06,22286,53651,-31365
674501,3828,2024-03-05,23061,25273,-2212
170447,9004,2022-07-10,98339,1568,96771
878394,9235,2024-02-11,29878,92606,-62728
449979,1351,2024-02-26,49332,20462,28870
192097,4059,2024-03-12,19990,52728,-32738
264730,5249,2021-12-18,8232,45780,-37548
189631,1644,2023-05-16,71006,46936,24070
613097,6318,2021-12-02,99917,15844,84073
387369,3051,2023-03-31,92015,98047,-6032
172121,4084,2021-10-25,44253,81891,-37638
944995,6150,2023-03-17,62102,78377,-16275
557358,9941,2024-08-03,98080,38218,59862
455874,4574,2024-08-21,93292,3241,90051
259028,7810,2024-01-11,45939,47902,-1963
614432,4717,2024-05-07,1579,28701,-27122
440293,7567,2022-07-28,32907,7035,25872
142310,8037,2021-10-25,23374,52205,-28831
794422,6688,2024-07-26,17848,6485,11363
259595,5770,2022-01-17,53323,35674,17649
305310,2623,2022-04-04,97708,63428,34280
399994,1807,2024-04-04,58807,86142,-27335
984627,7680,2022-03-27,15543,62882,-47339
619408,7290,2022-09-24,11498,65857,-54359
223655,9719,2022-07-19,41123,85697,-44574
533913,9644,2023-07-04,96447,16618,79829
443531,5685,2022-06-06,50559,93030,-42471
665254,4465,2023-02-16,25571,60069,-34498
136582,7011,2022-11-25,28801,5183,23618
292288,4224,2023-11-13,3239,30336,-27097
554811,6324,2024-04-13,11678,97692,-86014
155253,6150,2024-07-25,75781,87559,-11778
242121,8350,2023-07-27,34777,46792,-12015
208640,6969,2024-04-25,31862,21780,10082
589661,2745,2022-03-20,81856,49066,32790
920357,8970,2023-11-08,63722,47768,15954
753940,5965,2024-03-23,82974,43672,39302
644918,5770,2022-10-21,65638,42183,23455
977349,5328,2021-09-25,33366,38969,-5603
126341,9353,2023-05-04,14057,9494,4563
516544,9951,2023-02-17,63915,68160,-4245
792867,5953,2024-03-22,61827,56544,5283
987075,1082,2024-09-24,48528,63268,-14740
145114,2476,2023-07-28,80499,72669,7830
110407,6290,2023-01-03,60829,59473,1356
984122,4947,2023-11-26,81765,64507,17258
931666,5889,2022-06-22,38449,55395,-16946
463315,1711,2024-01-10,72233,99522,-27289
850474,6726,2024-07-09,58417,63841,-5424
832736,5953,2024-03-11,10631,83794,-73163
585843,4717,2022-05-30,22922,29754,-6832
643293,7454,2023-01-15,2000,26346,-24346
568530,9941,2023-06-30,41657,47061,-5404
165059,4399,2022-03-12,17319,15095,2224
874462,1448,2023-09-25,84723,79566,5157
641192,1173,2021-11-03,17286,8277,9009
156264,6371,2023-05-24,8377,9352,-975
497796,9435,2023-02-28,51894,84763,-32869
125971,6023,2024-07-21,78368,55805,22563
771091,4241,2024-07-29,66167,52056,14111
594482,4896,2023-01-23,21648,28748,-7100
414055,1750,2022-11-03,5200,46879,-41679
232298,1767,2023-01-22,19712,22471,-2759
512283,4002,2021-10-28,13011,27832,-14821
287831,5427,2024-05-22,98726,60855,37871
615390,2733,2024-09-21,96153,27311,68842
936851,5853,2024-05-04,78427,89879,-11452
246656,8442,2022-07-20,18136,77059,-58923
811053,1977,2024-03-05,60939,34836,26103
166432,1479,2022-08-24,45567,19262,26305
149632,2213,2023-01-08,91624,15279,76345
249524,5126,2023-05-03,16364,17268,-904
205931,6539,2023-05-09,88998,78074,10924
322098,1082,2024-06-15,1140,37690,-36550
286239,8267,2024-07-29,50459,78619,-28160
410014,1351,2022-06-25,68722,45814,22908
746676,5382,2022-08-01,69728,27588,42140
451394,4224,2023-11-07,45274,96305,-51031
410323,2692,2024-03-18,48088,42487,5601
441438,7174,2024-09-22,57797,86108,-28311
359582,5817,2024-05-31,72843,75764,-2921
844643,9865,2023-07-06,18737,63183,-44446
894492,6319,2022-07-26,95741,76366,19375
517399,5770,2022-06-20,56981,89997,-33016
217319,2426,2022-01-19,52958,99094,-46136
564647,5171,2023-01-10,76282,19393,56889
268026,8622,2024-01-01,25969,28997,-3028
211811,8797,2022-02-03,12791,62968,-50177
435165,5068,2023-03-23,86442,17784,68658
140045,7264,2024-01-01,22983,57868,-34885
326537,8773,2023-06-07,28831,91522,-62691
274946,5632,2021-10-25,47514,14174,33340
532642,3267,2022-03-13,2130,18402,-16272
308326,9474,2023-08-22,8182,96278,-88096
768543,8218,2023-07-25,86837,58685,28152
595044,8267,2023-12-16,92351,47748,44603
397726,1473,2022-11-26,6058,61594,-55536
716353,7786,2023-01-06,71762,58737,13025
586610,1847,2023-03-31,5395,62825,-57430
641501,1977,2022-08-09,5933,68512,-62579
131263,4002,2023-04-25,99102,26562,72540
429956,3015,2022-01-30,57673,58797,-1124
539291,8026,2023-03-08,44490,49866,-5376
311632,1118,2023-03-03,52107,13264,38843
622078,2105,2022-12-15,24159,69398,-45239
432853,3040,2023-07-07,81264,40778,40486
373625,6290,2022-11-16,51561,95403,-43842
951239,3498,2022-03-28,37618,13166,24452
413012,1553,2021-10-20,39161,82124,-42963
547416,5785,2023-05-17,93853,64758,29095
196238,7901,2024-07-09,3258,44360,-41102
914429,6149,2023-01-10,12431,47643,-35212
129496,1473,2022-03-18,18553,68813,-50260
252040,4224,2023-02-01,93521,36615,56906
937715,9128,2023-01-09,10247,27729,-17482
419847,5770,2023-05-03,26709,8104,18605
349980,5814,2022-02-02,51736,7353,44383
709627,4100,2024-08-06,2228,9790,-7562
322357,8582,2023-06-05,62215,10979,51236
655360,8469,2023-07-08,28817,41257,-12440
779355,9596,2023-03-17,56692,17566,39126
908781,6080,2022-06-09,98384,19295,79089
804668,4798,2022-06-05,92842,10888,81954
888781,9941,2023-09-11,12698,36001,-23303
612861,8970,2023-12-07,94409,60459,33950
751753,3776,2024-01-26,94706,27214,67492
567581,7439,2022-07-01,49745,2106,47639
636577,9023,2022-06-09,76719,80557,-3838
937690,8516,2023-03-10,14395,65584,-51189
424924,1227,2022-03-06,19719,2773,16946
443338,3222,2023-11-04,1929,72804,-70875
686534,6452,2022-11-27,84747,65660,19087
227858,5336,2021-11-01,49869,71405,-21536
580875,4798,2023-06-06,12026,49934,-37908
455854,4243,2021-12-31,79452,59677,19775
905971,9225,2022-05-13,12347,12299,48
315564,3050,2022-02-20,66814,82129,-15315
152609,1902,2022-12-26,11740,56097,-44357
900932,3832,2021-11-27,75113,66146,8967
533183,2213,2023-04-11,86674,45916,40758
482781,2251,2021-12-28,26454,52358,-25904
230287,1341,2022-08-26,33351,35214,-1863
979050,3144,2022-05-25,26972,38955,-11983
582337,1473,2023-04-21,24607,10489,14118
284665,3308,2024-09-15,39797,78478,-38681
645060,6290,2023-04-19,35931,74176,-38245
451086,5713,2023-06-10,16084,96498,-80414
321579,5484,2024-09-18,16991,58314,-41323
125771,2089,2023-07-27,22300,87613,-65313
901702,2210,2022-07-06,94565,36569,57996
401724,3572,2022-02-02,37471,38440,-969
261125,6563,2023-12-01,84032,93413,-9381
549540,6880,2022-01-05,32317,69628,-37311
433611,4107,2023-10-24,9160,31381,-22221
409773,5525,2023-12-21,85207,62852,22355
731350,5957,2023-08-26,42587,9832,32755
107294,9478,2023-09-22,1526,64481,-62955
162438,3450,2022-02-26,42988,82743,-39755
689124,6332,2023-09-07,91920,27182,64738
525655,7443,2024-07-19,56341,58284,-1943
422554,9007,2023-08-22,42163,7327,34836
981900,1644,2023-01-03,74631,83448,-8817
625878,9470,2022-02-25,53360,93245,-39885
693241,3721,2021-11-14,66920,87589,-20669
583627,5770,2021-11-02,50319,61649,-11330
685934,4597,2023-12-19,74215,84445,-10230
903830,7290,2022-05-31,81831,41221,40610
414766,1376,2022-03-09,40568,55083,-14515
764629,4107,2022-12-20,8182,93773,-85591
389629,9435,2024-06-10,6775,21116,-14341
159493,3891,2023-12-27,71947,71751,196
655184,5575,2022-09-28,2075,97288,-95213
882040,9865,2023-09-16,92777,93388,-611
147966,7263,2024-06-01,50397,21464,28933
982594,3891,2023-12-16,55771,87149,-31378
985130,9010,2023-02-16,50096,42083,8013
439419,4780,2023-08-11,42053,47044,-4991
212571,8860,2023-10-30,36378,86693,-50315
536579,7662,2021-12-04,24769,91281,-66512
449379,7165,2024-02-07,10922,92556,-81634
861860,8037,2022-03-03,99199,78817,20382
330602,5604,2024-04-28,38947,37728,1219
242632,1302,2022-09-11,94626,83831,10795
807057,2863,2021-12-23,71958,77010,-5052
119854,7810,2022-03-14,16072,34952,-18880
199920,9787,2023-06-23,3690,71371,-67681
286887,6150,2023-03-19,36329,19280,17049
286190,3791,2022-04-27,3939,16710,-12771
485727,5988,2022-10-18,11621,85936,-74315
139241,2288,2023-07-12,96760,18180,78580
976480,4465,2021-10-08,14941,17638,-2697
328700,1118,2022-06-19,65091,41909,23182
574344,8351,2024-08-30,69031,17657,51374
789193,4896,2023-07-20,52638,22151,30487
596916,4478,2022-11-20,28049,76592,-48543
166784,3891,2022-05-17,24758,33539,-8781
712494,5382,2022-08-28,69667,31987,37680
493709,3030,2024-08-02,19754,36985,-17231
323755,2139,2023-01-06,98038,24708,73330
239868,1808,2023-05-25,38726,57533,-18807
384505,3891,2024-02-16,34361,97939,-63578
138119,2984,2023-01-07,99748,64407,35341
100350,3832,2023-06-03,46346,62900,-16554
659493,2089,2023-08-22,79528,22344,57184
963797,8992,2023-04-18,79374,70376,8998
963947,5966,2021-10-24,14382,64318,-49936
710402,6205,2022-02-03,33290,81370,-48080
354298,1644,2024-07-26,60991,4406,56585
777951,6332,2023-04-12,23535,96010,-72475
692416,4595,2024-01-25,18973,93264,-74291
932531,8350,2024-04-26,80506,93770,-13264
303501,8442,2024-02-25,93273,81847,11426
812585,1435,2022-06-05,51869,82544,-30675
606903,6563,2022-02-04,42730,66818,-24088
347933,5249,2022-05-08,16918,9113,7805
322706,1537,2022-04-05,57666,35942,21724
863096,4227,2024-03-20,61226,77908,-16682
775592,5249,2021-10-21,1170,97891,-96721
318115,9713,2024-04-22,64770,22480,42290
787013,5478,2024-02-17,44957,25376,19581
743311,9719,2024-05-26,23510,61271,-37761
954484,6690,2023-01-28,83519,26218,57301
572191,8970,2022-03-02,14345,96829,-82484
487734,9981,2023-02-11,76058,44336,31722
258056,5575,2022-04-08,62707,40833,21874
844852,1847,2023-02-02,98261,73796,24465
135502,2640,2024-06-29,72574,52282,20292
655800,1847,2022-02-06,67463,22190,45273
590235,6332,2022-03-22,94203,49708,44495
569262,1735,2022-01-23,70281,83129,-12848
439576,5597,2022-02-16,43573,6450,37123
698132,8011,2023-10-28,95715,3812,91903
620327,5853,2024-08-05,94466,47070,47396
796730,8218,2022-09-19,5019,66833,-61814
465611,9713,2022-05-29,11851,17154,-5303
887049,6937,2022-01-12,85550,57274,28276
515762,2330,2023-03-15,22099,68778,-46679
129531,5592,2024-08-05,53010,23023,29987
486668,5966,2022-03-21,67669,74890,-7221
145049,9255,2024-06-14,99749,52468,47281
745030,6016,2024-09-14,6928,32043,-25115
213775,5853,2024-09-17,61957,36338,25619
389981,8970,2023-11-04,48874,93328,-44454
135077,9787,2024-04-23,24300,78709,-54409
636096,5071,2024-09-01,39966,85870,-45904
400023,4950,2024-09-18,72630,36971,35659
872920,9295,2022-05-07,38983,23065,15918
123005,8925,2022-09-29,4342,81546,-77204
703556,4086,2024-05-04,21548,11451,10097
678128,8425,2022-08-21,79454,73398,6056
512067,2579,2022-10-13,26244,68198,-41954
663379,6379,2024-05-25,17332,30833,-13501
107006,1449,2021-11-05,62840,3594,59246
641811,4950,2022-04-11,58784,67225,-8441
789350,7132,2023-04-16,4077,9333,-5256
506197,9903,2023-01-24,74723,61198,13525
773357,1308,2022-10-28,90231,1644,88587
884774,4177,2022-08-02,48348,38097,10251
939300,8817,2022-10-23,2180,53640,-51460
199734,7838,2022-01-28,25881,72895,-47014
911783,1902,2022-07-04,83195,2041,81154
247530,1179,2022-09-22,60024,44105,15919
186608,8011,2023-11-02,1104,12760,-11656
935091,2330,2022-08-17,90429,88867,1562
296939,7838,2023-01-01,62152,77843,-15691
903946,1902,2022-04-13,86575,72545,14030
945884,4676,2022-11-16,38892,96538,-57646
245092,3292,2022-04-17,26060,63731,-37671
875357,4309,2023-01-09,65394,35929,29465
385444,2579,2022-11-27,17109,81667,-64558
517497,5068,2022-12-09,56158,8248,47910
566404,5986,2024-07-01,19529,11048,8481
980220,4663,2022-09-24,43704,86265,-42561
800484,2821,2023-12-07,93995,60004,33991
916344,8051,2023-06-15,54753,98828,-44075
455160,6759,2023-09-27,84369,69241,15128
349635,5336,2023-07-05,8553,20977,-12424
699005,1473,2022-03-06,45220,55796,-10576
859438,3264,2022-12-26,10565,18838,-8273
963017,9951,2022-12-17,82495,31269,51226
412793,7662,2024-07-27,57422,17370,40052
366303,2733,2023-03-25,24329,54326,-29997
256241,2940,2024-09-19,81732,16885,64847
748676,7256,2024-03-06,88186,73374,14812
410847,3144,2021-10-17,10786,32299,-21513
688756,3851,2024-08-09,90657,23240,67417
973660,8691,2023-08-19,56266,19745,36521
189201,4717,2024-06-08,91353,28048,63305
982391,3450,2022-08-28,44772,57205,-12433
451208,7403,2024-02-19,42349,76956,-34607
246674,7470,2023-07-24,14650,81092,-66442
775068,5597,2022-01-25,63824,40872,22952
441816,2426,2023-05-21,7858,22565,-14707
414219,6688,2022-11-05,42314,46318,-4004
923440,8968,2022-01-12,42612,22407,20205
719058,2105,2023-02-03,77380,13428,63952
161324,6229,2022-05-04,41711,84761,-43050
373686,1785,2021-11-07,41746,26657,15089
990293,6663,2022-11-07,15921,23627,-7706
134285,3461,2023-07-12,51852,6956,44896
990245,7443,2023-12-26,32454,51982,-19528
618933,3821,2021-12-09,87924,32782,55142
548165,5986,2022-08-26,50700,37576,13124
904204,8166,2023-02-24,15498,97102,-81604
932808,4227,2023-05-02,63810,25105,38705
238261,5988,2022-05-07,84369,69918,14451
129849,1449,2022-07-12,46369,79260,-32891
250718,2785,2024-04-17,34838,18647,16191
934400,3791,2023-02-23,24727,38436,-13709
372113,4100,2021-11-24,54174,93256,-39082
479967,8358,2021-10-22,40837,90676,-49839
638514,7395,2022-09-23,86299,73631,12668
702923,7530,2022-10-08,56550,60197,-3647
934549,4532,2023-05-08,51246,66125,-14879
501782,8662,2024-04-12,49264,65858,-16594
385269,9353,2023-03-22,88793,22947,65846
401701,8343,2023-02-04,41254,93455,-52201
479543,8992,2024-06-26,99229,36486,62743
228408,7225,2022-02-19,45191,50752,-5561
530189,7152,2023-12-03,95370,3508,91862
545381,2640,2022-12-22,95055,39567,55488
344616,2074,2023-11-02,33481,67870,-34389
550096,3776,2024-01-20,92153,63128,29025
102420,2901,2022-10-30,66803,44269,22534
674505,7415,2023-11-27,39528,34352,5176
118379,8469,2024-05-30,60768,11978,48790
351711,4107,2023-08-15,21427,89652,-68225
687034,4900,2023-02-09,25571,54585,-29014
448753,3264,2022-10-10,25099,46318,-21219
249000,4002,2022-05-08,72956,74700,-1744
897463,5974,2024-07-17,2969,15726,-12757
782401,1173,2024-04-17,66355,50427,15928
568818,8797,2021-12-02,35828,74113,-38285
789632,8218,2024-02-16,50708,86008,-35300
804415,8011,2022-12-05,48797,17704,31093
313681,5713,2023-12-02,62344,19950,42394
189939,7290,2022-08-22,42219,75798,-33579
947812,9128,2023-10-01,93479,84754,8725
239824,2049,2024-02-29,84754,44460,40294
688715,6541,2023-08-18,23784,58268,-34484
835244,8036,2023-01-13,44720,69580,-24860
158482,6229,2022-02-22,50723,26659,24064
426928,1396,2024-08-30,98880,68663,30217
545297,6965,2023-12-26,50379,22472,27907
761807,6080,2023-11-07,26234,2456,23778
504456,4947,2021-11-17,23142,78951,-55809
194931,9951,2022-04-12,84953,13837,71116
461860,2868,2023-08-16,2642,4268,-1626
936929,8622,2023-01-27,28772,84911,-56139
186353,2089,2023-06-18,40583,36487,4096
270531,4595,2024-08-11,64129,45913,18216
929546,9865,2024-03-10,53585,36873,16712
825385,9743,2022-03-17,65974,98043,-32069
316761,5770,2023-05-15,41461,14722,26739
467732,2176,2023-10-22,47784,12352,35432
450895,9713,2023-12-07,58492,89512,-31020
643735,3776,2021-12-18,87953,64753,23200
782736,7470,2024-04-29,59448,1339,58109
604041,5575,2023-08-26,76971,48866,28105
931555,5770,2022-12-21,22486,73345,-50859
443138,9010,2024-08-08,38848,66310,-27462
782934,2579,2023-08-04,34071,63591,-29520
119180,2869,2024-03-27,41050,72018,-30968
389151,7454,2024-06-09,67995,60003,7992
821231,3292,2022-07-29,17675,25541,-7866
576887,2194,2023-08-21,3617,69188,-65571
967212,4432,2022-06-15,50533,83407,-32874
316643,9619,2023-07-20,89110,24939,64171
738732,1103,2021-12-19,47867,28425,19442
744575,4346,2023-04-25,81343,37709,43634
359332,2217,2023-08-31,73107,91209,-18102
115240,3108,2022-12-23,72497,84234,-11737
515228,5484,2021-10-11,86409,83280,3129
350145,2774,2023-02-11,78451,18226,60225
555623,3891,2022-03-31,90289,67075,23214
974593,5382,2022-08-30,97393,21945,75448
693299,7209,2022-01-04,65844,88830,-22986
328381,6735,2022-02-23,87166,99616,-12450
275470,1148,2023-03-26,61935,72572,-10637
786106,9865,2022-12-20,4524,90355,-85831
943669,8218,2022-08-02,14984,39813,-24829
491457,7303,2022-11-30,93925,31800,62125
283669,3292,2024-05-17,82334,66838,15496
728669,4900,2024-08-05,5147,72696,-67549
692516,4227,2024-04-15,47340,32077,15263
792301,3703,2022-02-21,20047,70374,-50327
919977,9255,2023-10-25,20691,77569,-56878
940660,8582,2024-08-25,71338,55799,15539
457827,3692,2022-09-03,81041,68005,13036
192770,8011,2023-08-31,4802,99338,-94536
546093,8976,2024-08-17,79407,25318,54089
435383,5328,2022-11-27,35279,38008,-2729
452194,4676,2022-06-15,80701,63754,16947
838507,3267,2023-08-07,61740,4916,56824
587181,4606,2022-02-08,98528,6236,92292
278034,7165,2021-10-19,86649,80741,5908
103970,3108,2023-01-26,48304,21763,26541
116179,1977,2022-02-16,31311,86928,-55617
970418,5713,2024-07-07,77518,79687,-2169
952509,4127,2022-03-08,38225,21882,16343
496531,8797,2022-06-02,37054,61961,-24907
958754,4086,2024-04-03,10618,17870,-7252
743397,5071,2024-05-07,41805,67541,-25736
501020,8773,2024-06-18,99407,25554,73853
993434,3450,2022-05-19,85409,86765,-1356
670265,1644,2023-06-27,84985,67031,17954
660824,8026,2022-11-06,61247,84276,-23029
108341,9082,2024-05-25,86446,75971,10475
173175,6759,2022-04-09,54305,67547,-13242
430234,3703,2024-04-06,66871,77417,-10546
593159,4461,2024-04-07,49340,25940,23400
674657,8483,2022-01-11,37581,56317,-18736
286601,5478,2023-11-17,72521,12533,59988
127768,8513,2022-10-15,94746,61731,33015
359087,9981,2024-04-12,16726,5128,11598
263088,7264,2023-09-20,98004,40125,57879
188430,6937,2022-07-20,19930,69147,-49217
276418,6563,2024-01-02,44793,22844,21949
451672,7901,2023-09-03,31665,24960,6705
898648,8925,2024-02-25,94461,77573,16888
475811,2984,2022-03-01,85399,82802,2597
313193,3222,2022-03-10,16643,76402,-59759
716944,6361,2022-06-14,74595,16307,58288
125345,6759,2024-03-07,89824,68641,21183
752982,3776,2022-11-08,63052,99591,-36539
471134,2869,2022-10-12,10339,48803,-38464
751699,4947,2023-08-23,27309,5503,21806
948859,2692,2022-02-08,11599,47043,-35444
420281,4798,2022-06-19,62719,89887,-27168
982136,4309,2022-09-27,62224,95323,-33099
725190,9309,2023-04-01,46925,93313,-46388
698541,7942,2023-01-14,96865,87700,9165
950114,2693,2022-11-17,50624,31977,18647
489713,1869,2023-08-15,94095,48788,45307
663797,1351,2023-10-20,91941,70504,21437
623268,1173,2023-11-24,14112,34230,-20118
639984,5385,2024-07-27,71871,75158,-3287
310525,6379,2022-04-24,31345,64674,-33329
265867,7470,2023-05-17,81812,55625,26187
887960,5965,2024-07-03,55524,61598,-6074
332048,1947,2022-09-07,92009,38484,53525
530162,4780,2024-02-25,68974,87561,-18587
662254,4811,2024-05-03,39466,92428,-52962
830756,8226,2022-04-23,8810,87332,-78522
644962,2611,2023-09-25,99759,56617,43142
790062,2176,2024-03-20,55207,13494,41713
530878,4574,2021-12-07,39883,3093,36790
620613,1082,2022-10-31,38132,3155,34977
697738,3023,2024-06-15,43226,95302,-52076
650093,4059,2023-02-11,67452,82016,-14564
273846,2217,2021-10-29,30843,45795,-14952
162515,8343,2022-11-12,37759,7366,30393
398904,2901,2024-09-23,42221,4450,37771
417995,7072,2022-08-13,49100,69481,-20381
872911,2215,2023-06-19,26250,92115,-65865
778415,9399,2024-07-19,38829,14893,23936
361172,7810,2022-06-28,81115,57915,23200
672693,2215,2021-11-16,92811,39601,53210
918120,1735,2021-12-28,42400,25743,16657
248633,4567,2023-08-06,85302,33992,51310
697355,9951,2023-06-29,14844,4512,10332
481106,2623,2023-03-30,61533,94413,-32880
505669,5328,2023-03-07,25586,2308,23278
859002,1948,2022-10-19,61307,33016,28291
856089,9327,2023-01-04,35834,67014,-31180
574449,5249,2023-04-16,42488,52093,-9605
630858,1479,2023-03-26,49868,25672,24196
700803,5953,2023-10-15,97449,18306,79143
371062,1063,2022-08-13,17700,78634,-60934
260257,6880,2023-02-12,67981,37537,30444
664797,3015,2023-05-13,84995,75696,9299
422333,7403,2021-10-22,78875,77748,1127
534219,3934,2022-02-03,98795,64143,34652
574570,3308,2022-11-13,58837,24908,33929
851649,3023,2022-03-05,74885,28751,46134
734466,7209,2024-02-23,58413,78675,-20262
976403,4245,2022-09-27,63500,71075,-7575
554797,8226,2022-12-27,2684,56642,-53958
709044,4968,2023-03-03,69259,57686,11573
859812,3040,2023-08-13,39169,25747,13422
776684,3368,2023-07-25,72533,30729,41804
517841,1785,2022-11-16,48066,24251,23815
886996,4950,2022-12-10,6045,99995,-93950
709313,6023,2022-05-26,51696,12429,39267
978045,9441,2022-11-02,18340,80699,-62359
720155,2611,2023-12-26,30033,23838,6195
583759,1566,2024-05-20,50678,20128,30550
140085,1435,2024-03-24,19225,61473,-42248
102748,1449,2023-01-27,75254,49844,25410
110879,8773,2023-04-24,52083,76256,-24173
687897,5525,2023-02-19,52808,85370,-32562
681502,8622,2022-04-12,34535,2739,31796
637346,3023,2023-02-09,87121,34019,53102
130238,3108,2022-08-31,69337,51352,17985
665031,9309,2023-03-22,1865,12004,-10139
647608,8725,2022-10-08,83209,51227,31982
441364,7256,2024-03-28,60479,77935,-17456
408903,9535,2023-02-06,41529,9318,32211
150834,5575,2022-09-15,28566,61094,-32528
366714,2774,2023-10-04,63133,48271,14862
569949,5894,2024-05-28,9640,76946,-67306
732595,5240,2022-06-01,66858,6089,60769
163747,3326,2021-11-05,72594,93367,-20773
151351,8800,2023-01-19,3084,12607,-9523
429968,9787,2023-06-03,71292,19350,51942
543113,4100,2024-06-03,30529,42077,-11548
717759,5749,2023-11-10,66235,31207,35028
819489,4127,2022-07-06,25935,71901,-45966
859439,2139,2022-12-31,4432,12913,-8481
226078,4227,2022-08-18,18674,81399,-62725
672230,3144,2023-11-16,99911,45442,54469
548843,6324,2024-08-18,50471,78046,-27575
843897,6324,2022-01-05,13066,48898,-35832
223299,7838,2022-07-29,94181,24372,69809
833159,9007,2022-01-20,25653,93277,-67624
703475,4432,2022-04-09,52990,27896,25094
444515,7239,2024-04-23,23903,16255,7648
113532,7120,2022-05-26,60501,34093,26408
969981,1165,2023-11-15,11717,48275,-36558
784212,8691,2023-07-19,38978,98587,-59609
572602,7231,2024-03-25,88927,15281,73646
127211,4574,2024-08-15,81495,47649,33846
360532,6150,2023-11-26,37424,53362,-15938
999813,9619,2022-08-21,85142,96380,-11238
456338,8110,2022-04-15,26993,69574,-42581
389180,7174,2023-06-10,99740,35292,64448
148516,5071,2023-12-31,53514,11698,41816
762106,7120,2022-04-02,16542,58401,-41859
435321,4243,2023-09-01,25048,66909,-41861
937069,5459,2022-12-28,62435,37887,24548
579825,2623,2022-07-24,66551,77050,-10499
776717,2745,2023-08-02,20846,6894,13952
984097,5974,2021-10-08,13377,50828,-37451
138463,1063,2023-01-02,88194,27414,60780
848487,1173,2022-01-27,62960,22659,40301
397668,7439,2024-05-24,19249,95884,-76635
438698,1302,2022-01-19,74547,19068,55479
215125,8987,2023-07-22,69500,40611,28889
691045,7786,2022-02-22,87084,8593,78491
212466,5785,2024-07-31,48968,51176,-2208
565463,9941,2023-03-23,85765,17304,68461
313310,6080,2021-11-24,11041,41921,-30880
130106,3821,2022-04-08,17130,37397,-20267
815695,5597,2023-09-02,91890,98875,-6985
591295,7818,2023-03-15,50228,86503,-36275
819343,8702,2023-10-03,35665,35747,-82
222304,5068,2023-09-27,34150,78764,-44614
417479,1768,2022-02-25,78544,7063,71481
188958,2692,2023-03-06,26600,17858,8742
594134,2868,2021-10-21,24237,47848,-23611
467564,7008,2021-11-13,25548,41727,-16179
672127,1341,2022-05-18,37808,16134,21674
867548,1194,2023-01-26,3032,6824,-3792
401232,4689,2023-02-22,81143,72777,8366
841129,5966,2022-01-15,68270,77474,-9204
919197,4726,2023-01-30,82070,84258,-2188
240706,1496,2024-04-03,78255,33953,44302
872000,5974,2023-05-30,70233,28397,41836
731112,3460,2023-10-27,36354,98633,-62279
635780,4224,2023-10-29,27800,37408,-9608
917575,1165,2022-10-11,32136,46293,-14157
607335,8358,2023-07-15,56824,64800,-7976
901060,3461,2024-01-25,40868,2784,38084
905022,3450,2023-06-25,20949,56682,-35733
811064,4726,2022-03-01,64083,81799,-17716
716185,7225,2022-04-08,34704,69706,-35002
419831,9010,2022-11-22,85817,79934,5883
533252,5604,2022-08-04,52841,56871,-4030
210889,8469,2024-04-24,92656,13299,79357
153077,8030,2024-07-08,21259,98631,-77372
430827,2774,2024-02-05,49528,24122,25406
228930,6541,2021-10-03,38142,19277,18865
804702,1194,2024-08-09,95901,33752,62149
855025,1750,2023-08-10,86566,22495,64071
634196,5459,2023-03-27,45162,81774,-36612
390305,5575,2022-11-15,34517,91843,-57326
300910,2868,2022-03-23,46052,65370,-19318
804213,1473,2024-01-08,43111,52910,-9799
628301,7786,2023-12-15,19591,23672,-4081
898934,5974,2024-07-15,9896,64706,-54810
499371,4539,2022-01-29,83146,75302,7844
379221,5597,2024-03-23,56209,57607,-1398
674812,2688,2022-09-27,54740,89933,-35193
945982,1880,2023-12-18,52774,72864,-20090
837705,8576,2022-10-07,89120,99457,-10337
405168,2857,2022-03-15,76355,46078,30277
386431,7403,2024-02-29,85806,83832,1974
139710,7022,2023-07-01,76031,97872,-21841
437175,8860,2021-10-14,64812,23035,41777
490212,1208,2023-06-22,45470,79403,-33933
134583,5157,2022-02-07,83633,99024,-15391
461095,1732,2023-07-17,88745,9599,79146
798696,5249,2022-11-14,45856,96273,-50417
905523,8110,2023-02-06,92405,24069,68336
876153,1461,2023-01-25,24116,23984,132
200825,1880,2022-09-22,24295,56445,-32150
588535,6318,2022-12-26,86186,7784,78402
239569,8351,2024-04-01,33901,14327,19574
926681,2972,2023-03-04,17774,25296,-7522
420898,4606,2022-04-28,75839,8475,67364
349770,4574,2023-07-05,16152,31004,-14852
115288,7008,2024-01-13,13547,5629,7918
599087,3144,2022-01-02,58473,80470,-21997
918984,3144,2022-08-18,65884,44942,20942
834467,1341,2024-09-05,89154,45821,43333
844736,5749,2023-08-08,72805,90828,-18023
729515,9004,2022-08-03,26108,39652,-13544
110085,4663,2021-12-20,13012,65364,-52352
526012,7152,2024-09-23,22244,49200,-26956
281544,9010,2023-07-26,61173,75730,-14557
300097,4367,2022-06-09,36125,72179,-36054
329880,8953,2024-06-17,8087,77987,-69900
138539,2733,2023-11-26,73272,76206,-2934
816657,8721,2024-03-12,96199,90881,5318
400071,9128,2023-01-22,79980,38391,41589
780637,9915,2022-12-06,53371,25794,27577
286171,9012,2022-08-31,63908,87421,-23513
307979,6205,2023-08-05,26416,66437,-40021
631422,4567,2024-03-29,27798,40671,-12873
853723,9951,2022-05-11,6690,54614,-47924
979183,1768,2024-03-03,61682,46326,15356
747591,5990,2023-05-16,29878,62280,-32402
192092,8218,2022-11-04,92668,38047,54621
729168,5126,2022-03-02,60313,7855,52458
487317,8357,2022-04-22,13044,60312,-47268
771569,2711,2024-07-04,82214,36224,45990
406081,5336,2024-03-24,63147,66104,-2957
963281,8905,2024-03-23,32315,99966,-67651
434935,9128,2022-04-15,22599,73590,-50991
639453,9007,2024-02-25,66969,32068,34901
162675,1768,2021-10-03,68148,24682,43466
458740,1808,2022-10-04,22635,33817,-11182
485392,1461,2021-11-13,20418,69040,-48622
655968,7359,2023-07-04,46928,77562,-30634
589891,1008,2024-08-19,22264,88262,-65998
461357,7818,2023-08-25,37055,27694,9361
825428,2611,2024-09-22,91652,71518,20134
213778,8622,2021-11-09,50815,37376,13439
918019,2623,2022-12-13,58553,65117,-6564
241108,2640,2022-07-17,79884,60969,18915
725590,2176,2021-10-21,28939,56220,-27281
902042,6880,2024-01-19,50387,68992,-18605
450828,8036,2024-05-17,73468,29189,44279
829724,1351,2022-11-19,50504,15217,35287
334884,1376,2023-05-11,84180,70348,13832
362546,6969,2023-02-22,75999,52177,23822
688753,5808,2023-09-17,59430,52266,7164
528670,3714,2023-03-11,36100,78835,-42735
281131,4968,2023-02-17,8948,23599,-14651
840183,4243,2022-05-07,71568,86892,-15324
546240,4595,2022-01-15,90694,56478,34216
839410,8905,2024-01-23,11301,6963,4338
625277,6371,2022-02-16,86684,29420,57264
424425,9042,2022-10-25,91292,97281,-5989
988268,8442,2022-12-15,81100,69981,11119
392042,6379,2022-03-15,55250,95298,-40048
700668,8622,2023-01-25,75228,60560,14668
783583,8267,2023-11-02,31080,47836,-16756
403734,8462,2024-03-03,9258,71425,-62167
297072,2556,2021-12-24,72808,68296,4512
959310,5126,2022-04-11,82394,16975,65419
869069,7567,2022-05-27,34639,52346,-17707
614551,1880,2021-10-19,19288,3729,15559
104977,2693,2022-01-11,24799,3240,21559
586566,6016,2022-04-26,81961,98265,-16304
542692,8218,2022-12-27,86432,70755,15677
346406,1767,2021-12-05,5159,15721,-10562
535041,3144,2024-08-22,23927,54337,-30410
204956,6690,2021-11-26,56473,63646,-7173
218779,2863,2023-02-11,66188,55513,10675
514484,5749,2021-12-28,37466,44037,-6571
593650,8037,2024-03-12,73814,37169,36645
691854,9235,2021-10-18,80562,34157,46405
670838,6937,2023-12-16,74071,30451,43620
198873,7152,2024-03-18,91401,31855,59546
598221,9023,2023-03-11,73830,75976,-2146
307345,8691,2022-03-19,50257,58530,-8273
922938,5974,2022-02-13,14633,32059,-17426
964206,7395,2023-10-01,55239,85697,-30458
906249,6080,2024-07-10,20776,29707,-8931
286002,6759,2023-03-31,79582,60897,18685
862620,2398,2021-12-23,93245,94816,-1571
631498,1376,2023-03-31,50017,9673,40344
181036,3712,2022-05-06,49781,24406,25375
124962,6563,2023-11-27,50676,71134,-20458
422315,9910,2023-06-20,17662,35303,-17641
582395,7165,2022-10-04,59847,29253,30594
650734,8351,2022-05-06,18876,94821,-75945
432918,5322,2023-05-25,33298,14315,18983
509156,1947,2023-11-11,98668,63152,35516
688665,5157,2023-04-20,93227,38185,55042
970133,1926,2022-04-21,69839,58812,11027
966431,7771,2022-11-15,71221,67919,3302
394629,2929,2022-03-11,17770,68720,-50950
924874,1179,2023-10-18,63240,89372,-26132
175181,8130,2021-11-28,7421,82221,-74800
160281,7786,2022-09-01,78999,59993,19006
632690,9132,2023-11-03,39730,51349,-11619
435603,3934,2022-01-17,97502,84704,12798
398870,1082,2023-06-18,39742,14562,25180
999012,8860,2021-11-26,96058,62302,33756
791308,3144,2022-11-13,32393,88296,-55903
763212,6324,2022-12-02,89098,66080,23018
341225,5004,2021-12-09,92008,99439,-7431
916078,5597,2021-12-08,71174,61274,9900
273371,2711,2023-04-06,91382,65520,25862
500597,4309,2023-05-11,92298,74574,17724
310430,1148,2024-07-25,11824,18960,-7136
345916,9441,2022-10-11,62933,12268,50665
327754,9327,2023-10-21,6033,24327,-18294
460028,1553,2021-09-30,7367,37569,-30202
419902,5004,2023-06-14,91208,44071,47137
116572,6691,2023-08-15,23139,83204,-60065
505997,8037,2023-10-09,45722,92938,-47216
846660,1341,2023-05-27,78439,13816,64623
954113,5604,2021-11-10,2825,32959,-30134
453259,4532,2023-04-01,3934,61643,-57709
355848,4198,2021-11-28,26288,67452,-41164
156961,7662,2024-04-09,54248,26306,27942
231913,3144,2021-12-30,25614,96459,-70845
595741,6150,2022-01-11,60946,9748,51198
848685,1435,2024-05-31,71949,78821,-6872
768937,5853,2023-01-14,69478,59560,9918
498104,5464,2024-03-18,7398,76082,-68684
225186,3194,2024-03-03,96210,62782,33428
536307,7838,2024-08-16,58556,83475,-24919
500399,3051,2022-02-05,35625,14692,20933
622731,2230,2024-04-26,36909,67266,-30357
862513,2476,2023-03-30,1711,37379,-35668
548245,2176,2024-09-20,31795,9669,22126
172287,5157,2022-04-18,80700,42368,38332
703717,1566,2022-03-19,96695,18768,77927
699114,4100,2022-09-08,92441,17999,74442
479658,1948,2023-12-08,31294,41862,-10568
671478,1473,2023-12-31,64432,85106,-20674
922483,1767,2024-05-19,77422,58236,19186
184184,7014,2022-10-18,49950,14063,35887
614565,8051,2024-05-15,15632,4557,11075
782461,8130,2023-08-06,56098,59538,-3440
543985,1308,2022-01-27,61072,37477,23595
289048,8011,2022-01-24,21450,92813,-71363
949729,6318,2024-02-19,87156,89072,-1916
869319,8011,2022-12-30,62478,35501,26977
602556,9116,2023-05-21,49641,72688,-23047
901020,8166,2022-10-03,55829,68683,-12854
215101,5336,2023-05-25,32416,45964,-13548
375591,3703,2024-02-12,20492,40623,-20131
766622,1947,2023-08-09,16046,57235,-41189
117936,1396,2024-03-29,88246,80794,7452
273020,5965,2022-09-24,59606,72267,-12661
881967,9903,2023-11-19,55060,56304,-1244
930285,1948,2024-08-11,62778,53496,9282
982880,7401,2022-12-24,42850,25215,17635
458338,8968,2023-04-09,47210,26283,20927
987665,5157,2024-04-03,8260,85913,-77653
790711,5592,2022-03-06,29875,73529,-43654
126196,7011,2024-06-17,1018,95219,-94201
557684,9317,2023-04-18,10915,15723,-4808
156628,7567,2022-09-28,92052,42308,49744
881474,4811,2022-05-23,30317,96771,-66454
442327,9535,2024-02-24,66389,35106,31283
307638,2426,2022-03-14,3891,77935,-74044
343156,1947,2022-06-07,62447,15962,46485
842302,4241,2024-03-26,98890,50428,48462
282311,5478,2022-08-04,62468,35063,27405
963150,2863,2021-10-15,54440,38117,16323
592342,1341,2024-03-03,51298,73320,-22022
330610,4261,2021-09-26,4727,77120,-72393
805833,2939,2023-05-21,81550,85450,-3900
685517,1396,2023-04-18,55913,53242,2671
783400,4699,2022-10-13,48924,17292,31632
245827,7239,2024-02-07,8719,87267,-78548
467943,5592,2022-08-26,91744,31476,60268
964895,9817,2022-06-29,36221,99010,-62789
845082,5916,2021-12-08,6304,15901,-9597
224112,8469,2023-02-14,53062,77575,-24513
231922,6690,2022-12-13,16262,83228,-66966
506327,6880,2024-09-16,16797,97909,-81112
445883,5770,2022-03-27,8130,22334,-14204
153855,6352,2024-08-21,96363,34073,62290
806522,8483,2024-02-26,45069,23483,21586
665740,7008,2023-06-25,93447,4160,89287
218180,3934,2022-05-03,48116,23537,24579
206926,9082,2023-05-25,18444,56116,-37672
604170,6541,2021-11-17,95515,56320,39195
430457,7036,2022-12-02,38230,35918,2312
323869,2176,2024-09-13,60449,4662,55787
252861,5071,2024-09-07,7187,73032,-65845
564096,1947,2023-01-14,50718,57686,-6968
625788,4999,2022-07-21,76162,9501,66661
332470,9309,2023-01-05,91334,67192,24142
490910,1461,2024-05-03,90988,70240,20748
631230,5427,2022-01-27,32239,58321,-26082
458953,8976,2022-06-19,63009,16718,46291
405008,6023,2023-11-12,16362,65957,-49595
982762,6726,2022-06-26,32472,95563,-63091
178076,2089,2023-11-04,11822,86615,-74793
789460,2929,2021-11-16,71368,54114,17254
628241,3319,2023-03-24,67316,58766,8550
824649,9817,2022-10-16,9872,82175,-72303
782503,9207,2023-11-17,55058,26215,28843
365940,3703,2022-01-25,62501,41918,20583
819964,5511,2023-10-14,80325,48635,31690
447655,4595,2024-06-22,31686,24410,7276
427317,1063,2023-02-19,33157,51592,-18435
396022,4726,2024-07-06,35147,8394,26753
949790,3832,2022-04-11,44263,97092,-52829
797797,8011,2024-08-20,48686,94530,-45844
383491,2774,2022-01-01,25020,17444,7576
725005,2901,2024-06-11,93022,32935,60087
291317,4086,2023-02-24,85376,13054,72322
746997,2251,2023-12-02,19836,42477,-22641
981852,2288,2023-02-17,5049,48055,-43006
318992,2785,2023-01-02,38164,69178,-31014
842088,4227,2024-05-02,60120,5252,54868
301358,5071,2023-08-14,74792,7342,67450
859832,6379,2024-09-10,32043,19318,12725
467250,9910,2022-03-01,69656,96756,-27100
365892,6290,2022-07-23,85734,66000,19734
324785,3572,2023-09-29,97605,48141,49464
105769,9535,2023-12-16,85191,16755,68436
604644,9327,2022-01-16,99463,49093,50370
863904,9128,2023-09-02,18866,62297,-43431
290748,5171,2022-05-26,23669,87202,-63533
653323,5808,2023-03-08,71409,10125,61284
264264,5192,2022-11-16,84842,23385,61457
895091,5953,2021-12-01,8287,30518,-22231
454676,5974,2022-07-04,10716,39847,-29131
962943,2213,2022-06-20,33396,98990,-65594
238437,7223,2024-04-17,89412,31036,58376
614047,4245,2023-09-09,74087,1825,72262
343788,8138,2022-12-16,50606,26780,23826
430516,5192,2023-02-16,42347,95278,-52931
373853,5382,2021-10-24,85671,40687,44984
720151,1847,2022-12-13,11180,99543,-88363
226785,7901,2024-06-24,39146,70037,-30891
337273,8647,2024-07-18,81424,36331,45093
120124,3264,2023-04-01,34014,51489,-17475
136257,5966,2022-06-20,7806,27043,-19237
357215,4689,2021-11-08,25792,3381,22411
210955,5770,2023-09-11,97075,61449,35626
347361,1176,2022-06-25,77535,76096,1439
821068,3692,2024-05-25,19837,29258,-9421
223531,8350,2024-02-24,94733,81299,13434
133860,9804,2023-03-01,62702,38846,23856
398696,9309,2022-02-05,30788,63839,-33051
270325,2579,2023-08-15,39198,16318,22880
287250,1767,2022-02-11,17944,80271,-62327
105094,4309,2024-05-07,24813,28071,-3258
231776,5626,2024-02-21,15923,57235,-41312
304434,8987,2022-07-10,1454,65994,-64540
414545,6083,2022-06-13,14184,66684,-52500
970668,9317,2024-07-10,42925,21420,21505
688915,6205,2023-12-21,61281,67635,-6354
785605,1227,2023-05-29,62017,65811,-3794
677265,1497,2021-12-04,58519,13625,44894
677001,9007,2022-11-21,38050,93075,-55025
574457,4165,2022-06-01,64817,67401,-2584
509357,7901,2023-03-28,80843,13091,67752
333972,3144,2022-06-12,85924,52052,33872
704790,6023,2023-10-31,98553,88699,9854
145527,4243,2022-06-22,14298,97362,-83064
760099,8460,2024-04-08,73799,57652,16147
902904,5853,2024-06-15,86229,98294,-12065
250396,6563,2024-07-16,3085,6651,-3566
286844,9132,2023-03-31,47095,2349,44746
547246,2869,2024-05-27,40953,35187,5766
319745,6229,2022-12-06,82084,94784,-12700
235772,7152,2022-06-28,63887,65343,-1456
755546,5330,2021-10-31,43786,82247,-38461
527409,7901,2024-01-21,17324,92811,-75487
202085,1286,2023-08-30,28855,41511,-12656
505949,5894,2023-02-12,73131,81388,-8257
570982,8351,2023-07-27,45962,6291,39671
278076,5158,2023-08-16,79395,70592,8803
881731,7470,2024-02-27,73326,91342,-18016
445368,6023,2024-05-25,38417,3677,34740
248514,9007,2022-11-02,25439,96235,-70796
805570,9060,2024-03-16,63460,58979,4481
470905,3791,2023-12-10,60232,86179,-25947
666927,2901,2023-08-03,51798,62468,-10670
508607,2288,2021-10-06,67743,86413,-18670
791499,2774,2023-09-17,17847,15303,2544
613828,5685,2022-03-24,65507,85229,-19722
208282,2939,2024-02-26,23550,88317,-64767
722777,9865,2022-02-03,17455,59531,-42076
111069,1227,2024-01-16,51831,44136,7695
893230,9116,2023-11-24,42398,47635,-5237
676582,6563,2021-11-01,1894,99811,-97917
420920,2611,2023-08-18,24626,98874,-74248
568909,1173,2022-01-12,9586,27249,-17663
724456,3712,2023-01-22,10687,79604,-68917
305753,9116,2022-04-30,84545,90899,-6354
865998,6541,2024-08-06,46603,75633,-29030
904318,4224,2022-08-21,31442,12942,18500
353668,4198,2023-02-25,89909,46540,43369
407312,1735,2022-04-21,61423,88855,-27432
213277,6080,2023-06-03,14721,77203,-62482
882302,5068,2023-02-16,16773,73876,-57103
442357,7014,2023-05-13,10327,7137,3190
598618,2901,2024-03-18,71109,95824,-24715
649784,6205,2024-07-01,23602,80599,-56997
579475,1520,2023-09-06,5147,89045,-83898
510809,5986,2023-09-24,85443,98057,-12614
950617,7095,2023-01-28,9907,13986,-4079
557430,7330,2024-09-07,97582,99136,-1554
858956,1216,2023-12-06,52260,10730,41530
866976,1448,2021-10-09,79917,15258,64659
215788,3050,2022-01-29,27344,80945,-53601
430304,9442,2022-06-04,9998,34066,-24068
751396,7022,2024-04-23,72896,51492,21404
596594,2902,2024-05-10,44155,8755,35400
918784,9903,2023-01-07,91303,15326,75977
879350,1948,2021-11-27,85810,49386,36424
732454,4567,2024-01-12,60244,47039,13205
264010,1435,2022-01-22,6546,36922,-30376
638831,5597,2021-11-15,66392,11758,54634
149766,7439,2024-05-29,10794,39427,-28633
699808,4399,2023-05-11,52486,69534,-17048
540708,3891,2024-03-23,38999,93392,-54393
527208,4091,2024-04-12,43685,78244,-34559
431779,4717,2024-05-01,11141,70065,-58924
943891,8138,2022-07-25,15999,26227,-10228
341355,8036,2023-04-16,33358,41816,-8458
278511,1376,2024-07-28,48638,47007,1631
465352,1869,2022-05-23,40693,30087,10606
246755,7786,2022-03-18,44637,35823,8814
532348,6685,2023-07-15,57456,42076,15380
600721,5484,2024-05-25,41351,33977,7374
323204,9941,2022-02-02,29330,99411,-70081
749241,3267,2021-12-07,23608,13316,10292
564283,9538,2022-06-22,93921,69651,24270
648180,9951,2024-05-08,22575,77861,-55286
202171,5068,2023-09-25,74098,54350,19748
517980,7771,2024-02-03,73386,73256,130
820298,6880,2023-10-22,18783,75025,-56242
903695,3692,2023-06-16,70924,3529,67395
753026,5604,2022-12-19,5056,12733,-7677
432877,2450,2024-04-28,66538,59129,7409
557568,6150,2022-08-05,62340,48646,13694
217618,3291,2024-06-30,77208,73308,3900
189737,4002,2023-06-03,73108,93770,-20662
115016,5575,2023-11-22,16514,35755,-19241
338148,5604,2023-10-25,19112,82850,-63738
950376,3267,2024-09-18,24156,14375,9781
163015,9441,2022-07-22,14713,40470,-25757
151118,2939,2024-09-02,13259,86442,-73183
880168,9042,2021-12-03,50752,10910,39842
936466,7223,2023-03-19,89109,74314,14795
494144,2688,2021-11-29,7578,93769,-86191
491836,8662,2021-12-04,48457,56050,-7593
938821,7028,2022-02-25,27825,19634,8191
965987,1520,2021-10-19,98400,20406,77994
200704,2426,2022-10-31,46551,85863,-39312
729057,9353,2023-06-12,5125,68149,-63024
968953,1926,2023-10-06,56590,33541,23049
107309,5604,2024-09-05,97888,48486,49402
843209,9317,2023-09-06,34520,90665,-56145
349409,2210,2023-02-28,73639,68737,4902
679368,7771,2023-08-20,90912,13373,77539
912979,8999,2024-01-06,36327,42429,-6102
571133,9255,2021-11-19,33345,31939,1406
771317,5180,2024-03-01,34878,26471,8407
956320,4574,2024-02-16,76418,11423,64995
852522,2426,2022-09-15,52233,22378,29855
361465,3461,2024-03-09,62181,56788,5393
651744,2711,2024-05-11,8924,89272,-80348
323505,9910,2022-01-26,98847,22497,76350
134677,1517,2023-02-12,80890,87869,-6979
283193,1063,2022-11-17,47352,89613,-42261
203528,6280,2022-09-02,5875,49407,-43532
358014,4947,2023-10-03,49732,55284,-5552
615591,6318,2023-08-31,65105,29354,35751
203021,9055,2023-08-18,60724,58515,2209
314326,9399,2022-04-06,99352,26974,72378
373924,6324,2023-01-16,32115,41835,-9720
866363,8267,2023-12-05,26862,89233,-62371
149605,9060,2021-11-14,34902,37084,-2182
249681,9981,2021-11-07,10979,21148,-10169
246633,5705,2022-03-21,51320,99978,-48658
696061,4224,2024-06-20,58569,97030,-38461
137054,7264,2022-01-21,45696,74717,-29021
305010,1308,2024-02-09,15977,1211,14766
250981,8817,2024-03-15,16572,83252,-66680
787304,7510,2022-03-04,71689,21236,50453
989138,2194,2023-06-23,33581,13896,19685
868709,9981,2024-02-11,8489,99819,-91330
486914,4597,2023-12-28,69872,70482,-610
853088,4676,2021-11-05,54552,38570,15982
816695,4574,2022-04-11,29961,96977,-67016
729970,8970,2023-04-23,30445,85291,-54846
917426,5330,2023-04-16,4644,16609,-11965
484273,5889,2024-04-03,58156,36222,21934
261899,8970,2022-04-17,40121,29112,11009
390587,1651,2023-05-27,76778,51043,25735
932627,1496,2021-10-23,80876,25529,55347
889881,5192,2022-07-07,44302,6582,37720
112772,8350,2023-02-18,78784,74888,3896
578840,3264,2024-01-13,70858,9088,61770
391297,2074,2024-02-27,27252,76343,-49091
985068,8319,2023-09-20,86987,32845,54142
287635,8987,2023-03-24,96093,27141,68952
460682,3572,2024-06-29,85767,50152,35615
432680,2579,2022-11-12,3282,47294,-44012
546477,8773,2024-06-30,2386,91541,-89155
948130,6759,2022-03-21,51461,50305,1156
264615,6539,2022-01-09,75140,86021,-10881
753883,3934,2024-02-02,52757,59388,-6631
779776,1566,2022-08-30,79288,52814,26474
139987,3972,2024-07-02,30560,7107,23453
802493,3498,2022-11-27,74040,47290,26750
995294,2785,2023-05-23,14117,11339,2778
730936,4369,2022-09-24,9730,28813,-19083
983273,2215,2024-02-20,31042,36904,-5862
758802,4539,2023-04-10,5396,93776,-88380
676966,9672,2023-07-21,7583,54299,-46716
556061,1954,2023-08-04,20172,46112,-25940
897274,3222,2022-01-08,80369,56501,23868
263842,2745,2024-01-24,43864,71499,-27635
503978,7470,2023-01-02,88309,55836,32473
422151,4208,2022-01-14,8850,90250,-81400
862567,8483,2022-10-05,95763,93210,2553
955652,6229,2022-07-17,70261,61437,8824
540837,6691,2022-12-14,17273,1269,16004
178814,9235,2022-04-16,80499,32780,47719
690073,5319,2023-06-18,86862,7392,79470
427856,6149,2023-04-09,7169,34225,-27056
122908,4227,2023-07-19,62901,9790,53111
396832,8992,2022-04-17,74812,12391,62421
722694,5941,2023-08-31,11526,4908,6618
443739,5319,2024-08-29,88427,41299,47128
612713,8425,2022-07-17,39499,97919,-58420
329181,6379,2024-02-22,83638,6584,77054
101827,8425,2022-09-05,97574,63965,33609
810169,3030,2023-04-27,93854,41231,52623
385651,7790,2024-09-16,25777,39988,-14211
849237,1948,2023-08-29,85619,79164,6455
763463,4896,2023-06-03,26457,40313,-13856
899502,6726,2024-07-10,43323,16742,26581
282263,4947,2024-07-31,5945,3677,2268
704664,8425,2022-02-05,70376,85361,-14985
704315,7209,2024-04-07,40195,6179,34016
381393,2408,2022-04-16,59198,78293,-19095
950802,2579,2024-02-04,36862,77284,-40422
767109,9435,2023-09-05,53924,79369,-25445
699699,7786,2024-07-31,10111,12127,-2016
655030,4889,2023-03-22,58277,57151,1126
619505,5319,2023-03-11,89177,91538,-2361
619295,5385,2022-06-08,8849,54207,-45358
615587,1644,2023-06-26,64392,1803,62589
692292,5632,2021-11-08,8086,28227,-20141
158581,8358,2024-08-10,62839,9311,53528
107883,3050,2024-08-04,49002,19076,29926
652879,3593,2022-09-14,85995,47699,38296
914833,9644,2024-01-24,24091,53987,-29896
855922,8905,2022-05-14,68468,27892,40576
262916,5575,2022-03-29,29525,38796,-9271
964267,9197,2022-08-21,12188,10904,1284
129872,2982,2022-06-22,93131,27406,65725
418512,5749,2022-06-24,73765,2793,70972
314671,8462,2022-11-06,93737,88377,5360
131356,8905,2024-01-26,61590,98534,-36944
596470,4703,2024-09-09,38463,84760,-46297
930040,5966,2022-10-12,64661,75430,-10769
795164,5957,2024-07-08,12218,57015,-44797
986372,8860,2023-05-19,89694,20621,69073
429057,5785,2023-12-22,34450,56609,-22159
238794,5953,2022-01-25,88998,27153,61845
571193,4227,2022-11-24,95653,9301,86352
561014,8425,2021-12-03,1053,37009,-35956
230211,1496,2023-08-14,73162,68537,4625
772796,6324,2023-03-20,30912,38664,-7752
315653,2450,2022-01-04,94626,94848,-222
165713,1396,2024-03-15,36755,74199,-37444
497584,9042,2024-02-27,72046,2706,69340
987083,7132,2022-09-10,44561,23510,21051
772131,1785,2023-05-06,88306,28423,59883
382132,7415,2023-05-23,61059,25143,35916
517551,6379,2023-02-13,1295,81381,-80086
686829,4165,2022-04-27,80109,47697,32412
476886,7439,2021-12-24,24387,59170,-34783
994345,1768,2023-02-24,70961,54750,16211
693100,6688,2022-09-29,41093,83623,-42530
541923,6759,2021-12-26,79902,27715,52187
826382,7011,2022-05-13,99534,21784,77750
594698,1768,2023-02-08,17248,10491,6757
701643,9619,2023-06-02,23415,99009,-75594
398931,5575,2023-04-12,32759,76761,-44002
515044,8226,2022-02-27,84498,11564,72934
643791,6205,2022-10-15,64843,64655,188
414131,9470,2022-01-30,81882,73566,8316
639489,7120,2021-10-12,23860,12157,11703
436785,3692,2024-05-15,9146,19017,-9871
274422,5592,2022-10-01,19532,4833,14699
114187,3291,2024-08-20,22522,93062,-70540
232659,4798,2022-02-14,50698,22892,27806
398946,9470,2024-01-31,59588,58962,626
326085,7014,2023-09-18,59965,9333,50632
230282,1553,2023-08-25,4276,54813,-50537
548599,5916,2023-03-20,48604,73874,-25270
474973,7174,2022-06-20,71428,11149,60279
646556,7415,2023-05-15,66728,38358,28370
144335,9672,2021-12-03,15957,28774,-12817
244592,8576,2022-12-10,63988,24387,39601
621390,6150,2022-09-03,11755,88591,-76836
867366,5986,2022-03-26,20143,28824,-8681
315755,9295,2023-11-24,14436,12739,1697
853569,5068,2022-05-03,28934,56833,-27899
820872,4478,2021-12-04,11514,72015,-60501
609668,4245,2022-08-01,32553,40038,-7485
715478,2579,2024-03-20,69717,60020,9697
699395,7470,2024-01-17,36777,32418,4359
994070,2821,2023-11-29,99817,63421,36396
178049,1767,2023-04-08,22461,95333,-72872
860067,4663,2022-06-27,30733,18985,11748
589926,6318,2022-03-18,23613,52816,-29203
549478,3144,2022-08-03,48087,8829,39258
546826,1767,2023-06-12,54801,18242,36559
806266,1977,2022-12-12,13264,10462,2802
154973,6324,2022-08-11,63580,68991,-5411
228000,9132,2023-09-01,67734,49375,18359
661318,8166,2023-07-04,94700,26421,68279
311503,3030,2022-01-04,72765,56075,16690
265467,7901,2022-08-30,64880,31819,33061
727832,7132,2023-09-08,90695,21576,69119
450958,5171,2022-05-12,73056,79219,-6163
172080,2450,2022-02-24,50788,57495,-6707
815077,1537,2022-10-24,28969,13113,15856
373670,5798,2023-06-12,37384,7796,29588
106531,6016,2022-10-27,61080,87121,-26041
492487,2972,2022-07-15,40604,85312,-44708
149048,9235,2023-06-04,64655,85940,-21285
497952,4597,2024-06-28,91809,72629,19180
353179,6149,2023-04-17,15132,3575,11557
805690,2193,2023-01-12,92752,78965,13787
595908,3267,2023-06-13,7451,49244,-41793
192403,6969,2022-07-19,59712,78128,-18416
295797,2011,2024-04-07,39331,57133,-17802
735936,2929,2022-02-13,1817,43440,-41623
825678,3015,2022-09-23,59631,51429,8202
447744,9248,2023-08-17,29158,14469,14689
807418,6452,2021-12-26,37492,58397,-20905
918466,1386,2021-12-21,31943,22616,9327
666464,7510,2023-05-24,2220,77362,-75142
578492,9235,2024-09-19,99616,84588,15028
199627,2049,2022-01-01,52817,41636,11181
489724,1208,2021-12-08,45918,51832,-5914
155292,6726,2022-03-12,55409,55027,382
251176,1767,2023-07-17,26344,19426,6918
168469,9951,2023-10-03,49816,1191,48625
812214,3934,2021-11-01,52273,98772,-46499
309765,9941,2022-10-11,99627,23486,76141
657462,3891,2024-01-25,92047,89788,2259
770727,9787,2022-05-29,56767,65078,-8311
178256,8218,2023-09-14,20112,85325,-65213
474048,2288,2021-10-25,17412,63544,-46132
208767,2105,2022-07-21,16814,42105,-25291
383207,5808,2022-04-27,24873,99130,-74257
923547,2105,2023-02-25,20245,22935,-2690
738935,2868,2022-09-22,84652,81317,3335
472108,2991,2023-01-28,7945,79112,-71167
149971,5511,2023-11-04,3956,81696,-77740
385122,4597,2024-04-11,74740,43975,30765
886239,3411,2021-11-20,42163,53845,-11682
805303,8442,2024-04-06,79443,7452,71991
750092,7635,2022-11-04,50250,28575,21675
776720,7401,2022-08-27,6349,20808,-14459
386495,7165,2022-05-24,25569,10679,14890
345752,2672,2023-10-11,19226,22669,-3443
126049,1948,2023-08-25,13579,77646,-64067
729566,2330,2022-12-13,84379,70149,14230
720371,6371,2023-05-20,33095,75937,-42842
919036,5386,2024-07-17,52432,32896,19536
732838,7454,2023-07-10,78231,46737,31494
874052,6735,2024-01-10,53706,66344,-12638
210723,9132,2023-03-08,20942,16936,4006
656170,4574,2022-07-09,78815,75734,3081
384069,3319,2024-06-24,34366,90568,-56202
705456,2929,2022-08-31,67934,58495,9439
287075,2868,2024-05-20,88371,15750,72621
279138,9435,2024-01-01,87034,19021,68013
998607,4243,2022-05-30,17400,9788,7612
404343,7443,2023-07-02,80592,32156,48436
731968,7264,2024-02-24,92691,36167,56524
419207,2940,2021-11-28,13394,78235,-64841
714704,4703,2021-11-03,5874,56119,-50245
943708,3108,2022-05-18,72164,16277,55887
323646,1869,2024-01-15,54977,54530,447
316008,3692,2023-03-14,22566,29094,-6528
227258,2693,2022-07-27,95767,63747,32020
756081,8905,2024-03-23,5141,24681,-19540
941215,1448,2022-05-27,63418,79680,-16262
932160,9596,2021-12-07,43592,38313,5279
846368,7359,2022-09-14,25504,17714,7790
388856,1926,2023-01-20,91615,84899,6716
924399,3934,2022-06-19,31878,7296,24582
702993,2210,2023-07-05,88799,83710,5089
752326,4950,2022-07-09,16895,93981,-77086
447473,8953,2021-10-20,46730,60538,-13808
432920,5247,2023-03-06,1796,2578,-782
521808,8721,2022-08-01,9194,73335,-64141
676826,4811,2021-09-26,66109,42003,24106
738433,1732,2023-10-02,41518,86275,-44757
443416,3891,2021-09-25,88799,40830,47969
205883,2640,2023-02-08,38453,58589,-20136
823001,3319,2024-04-14,71210,4602,66608
487005,9910,2022-11-13,41773,31174,10599
370503,9442,2023-06-07,99174,87070,12104
754151,5685,2021-12-14,15401,47339,-31938
964079,7330,2023-04-16,43688,57169,-13481
154027,6965,2024-02-25,43067,76654,-33587
975210,5988,2023-09-01,5348,73740,-68392
879324,6319,2022-12-19,8227,62980,-54753
474665,4717,2023-02-10,54885,18384,36501
251520,7152,2022-07-06,89632,74983,14649
347749,7790,2024-03-20,75777,41039,34738
504261,1902,2022-01-23,75266,99254,-23988
715278,9435,2023-08-02,38200,28654,9546
880753,8051,2024-07-11,69100,6014,63086
603280,1768,2021-12-07,57353,6676,50677
256453,1537,2022-10-14,14480,6228,8252
632991,3144,2023-01-29,10501,58835,-48334
726611,1833,2022-01-01,88166,83454,4712
357622,1396,2024-04-09,89254,26302,62952
104618,7036,2022-08-04,98026,47143,50883
467417,9004,2024-02-05,16728,10429,6299
524587,9207,2022-10-07,81614,91073,-9459
371906,3144,2023-08-26,17222,74594,-57372
953555,3450,2022-08-21,21046,5289,15757
811148,7911,2024-09-03,43596,60835,-17239
749612,1553,2024-01-03,52902,21866,31036
420705,4735,2023-03-10,2334,38569,-36235
285843,2556,2024-08-01,35607,93212,-57605
139107,6150,2024-01-23,10660,67957,-57297
979806,9255,2022-04-24,96539,14962,81577
650207,1449,2022-01-31,52281,59677,-7396
957492,9116,2022-10-21,82047,30697,51350
606124,7443,2022-09-21,58557,11681,46876
440911,8691,2024-06-29,52437,93712,-41275
415386,4699,2023-04-26,95591,86350,9241
358100,3022,2024-07-06,32944,55481,-22537
921398,9817,2024-04-28,69898,89835,-19937
943155,4399,2022-09-28,1270,83023,-81753
407914,5966,2024-02-25,26639,61766,-35127
238502,1435,2024-09-08,12182,30613,-18431
743516,2330,2022-07-02,96961,19836,77125
782551,7166,2023-08-09,55962,24896,31066
250728,2210,2023-06-06,5154,84542,-79388
599995,1882,2022-02-07,2190,89926,-87736
687403,4241,2021-10-18,2471,91868,-89397
131220,4107,2024-05-23,85205,83245,1960
827235,9435,2023-09-28,9889,73154,-63265
255044,9713,2023-11-27,95289,18050,77239
200197,2330,2023-08-27,68365,83746,-15381
587951,5770,2023-01-30,21342,39883,-18541
618877,8037,2022-07-27,59170,16740,42430
674522,5247,2023-02-25,18427,61899,-43472
318047,2105,2022-06-20,43313,33300,10013
288996,9223,2021-12-30,68406,13782,54624
792199,8037,2022-10-04,59693,7813,51880
744707,5808,2022-02-22,2436,94704,-92268
114093,8925,2024-02-23,68737,15344,53393
685379,6083,2023-04-06,40744,41630,-886
622437,5990,2023-09-14,66483,75156,-8673
142301,3194,2022-03-09,39676,27030,12646
915227,3821,2024-08-13,70170,57875,12295
719231,5158,2023-02-10,28024,58246,-30222
646545,8357,2023-06-25,13905,16145,-2240
240626,9865,2022-08-28,39397,5700,33697
250996,8460,2023-07-17,8309,76166,-67857
896142,1104,2023-04-25,62724,12831,49893
500011,4243,2024-05-09,55490,15571,39919
162330,1807,2022-07-22,73314,20315,52999
193160,8976,2022-03-03,25864,76181,-50317
849602,4574,2022-02-04,96513,70206,26307
461575,5319,2024-06-29,33454,75571,-42117
872973,5597,2021-12-03,19480,81124,-61644
229868,4597,2023-04-27,40725,10465,30260
721439,1807,2023-02-14,90062,8880,81182
211169,3461,2023-10-13,74538,66058,8480
254440,2426,2021-11-12,69337,52275,17062
175610,9197,2022-03-20,56437,64482,-8045
668319,9817,2022-05-30,95231,56885,38346
181067,1148,2024-01-23,64011,38667,25344
966565,3498,2023-07-07,72837,19040,53797
721020,8130,2023-02-07,90726,8922,81804
368165,3461,2024-07-08,21244,51373,-30129
829417,7510,2023-08-23,35341,6871,28470
916213,7011,2023-04-01,88164,90588,-2424
939079,1286,2023-07-17,16388,82356,-65968
790738,6880,2023-02-19,49010,91188,-42178
105502,9787,2022-09-14,47445,44236,3209
203425,5770,2022-09-07,74510,85394,-10884
573453,5798,2022-07-28,50062,90349,-40287
955151,3776,2022-08-27,95278,62942,32336
869185,8130,2023-07-15,44536,51721,-7185
438602,3144,2022-07-31,34202,27080,7122
358299,1386,2023-04-15,36437,8247,28190
653859,3692,2024-07-04,74489,33727,40762
918357,5192,2022-01-30,38551,12690,25861
264297,4399,2023-08-06,22581,62246,-39665
719630,2398,2022-08-01,54216,48159,6057
738720,5916,2023-01-30,22464,80747,-58283
201072,2074,2022-05-08,12136,25117,-12981
898321,6361,2024-01-14,95792,89980,5812
683899,3326,2022-11-14,94628,85312,9316
883449,6476,2023-08-17,7631,33748,-26117
455665,9207,2022-05-11,30057,97933,-67876
505288,9818,2023-03-22,65194,8379,56815
512787,9901,2023-03-17,5336,16925,-11589
518742,7911,2023-03-09,17511,86464,-68953
520083,4532,2022-04-05,50207,49484,723
507751,2937,2023-11-14,33861,7759,26102
233551,4363,2023-05-09,33651,93027,-59376
979477,5478,2023-01-16,9679,13367,-3688
586175,6284,2023-03-26,97041,73706,23335
297352,4717,2022-09-15,48424,80538,-32114
488681,1537,2021-10-20,47046,74272,-27226
225891,7011,2022-05-22,54379,66884,-12505
181265,4243,2022-03-24,80646,21172,59474
866752,9004,2023-06-25,88936,68453,20483
164304,8817,2022-07-18,81507,48910,32597
849922,7152,2022-06-11,69434,87812,-18378
343950,5626,2022-08-25,94736,94648,88
293637,2139,2022-09-28,29729,52309,-22580
885193,5953,2024-04-30,5388,74607,-69219
918944,8516,2021-10-30,60290,12438,47852
930247,6324,2022-04-27,47655,40059,7596
993500,2869,2024-08-06,15835,27953,-12118
125190,1520,2022-07-08,90307,99407,-9100
136878,8037,2024-08-28,41442,75343,-33901
876539,4798,2024-03-05,56262,99659,-43397
950651,7290,2024-03-01,79064,12808,66256
398612,8358,2024-06-10,13546,58896,-45350
455169,5632,2021-12-24,79793,33344,46449
174968,4127,2023-02-17,10883,77265,-66382
879299,7838,2022-05-04,24105,6170,17935
837643,6352,2023-06-16,30152,19390,10762
181439,4999,2023-11-04,80113,13475,66638
932282,4896,2023-06-15,6730,67380,-60650
197074,1165,2022-11-13,39739,38174,1565
992833,1833,2022-02-15,99726,53213,46513
289192,1351,2021-11-03,23457,15952,7505
247160,3712,2022-09-14,78813,72943,5870
223266,1351,2023-07-01,49700,92573,-42873
558402,4606,2022-04-29,90915,10459,80456
513353,1785,2023-08-18,68761,77336,-8575
902791,5459,2022-07-13,86163,6121,80042
157796,7670,2022-07-09,95243,47301,47942
163822,6371,2023-06-03,99041,79539,19502
377129,4107,2023-12-24,49926,32009,17917
257260,7011,2022-08-13,42615,90676,-48061
909160,3714,2022-06-15,14011,13706,305
552863,3326,2023-12-17,60187,97837,-37650
144974,2733,2022-05-02,15491,83305,-67814
765373,3050,2022-09-27,67010,3067,63943
240376,5953,2024-06-19,85747,29700,56047
563305,9787,2023-10-05,16684,51354,-34670
310420,1520,2022-05-17,18645,47383,-28738
295637,6080,2023-03-23,28065,40690,-12625
813046,2013,2022-02-08,56109,7353,48756
830336,3461,2022-11-21,15160,91323,-76163
707421,2857,2023-09-25,50452,25393,25059
556865,5336,2022-10-15,82913,4709,78204
522763,1735,2023-08-26,58021,36571,21450
638901,1060,2023-08-02,21080,83458,-62378
649079,6290,2022-06-03,5321,68016,-62695
370481,5685,2023-02-21,26683,5313,21370
761756,5126,2022-12-04,75454,14566,60888
428146,7680,2022-04-18,69163,24404,44759
550749,2745,2024-06-05,23836,87259,-63423
495135,8970,2023-06-22,7505,9659,-2154
597905,2929,2024-09-16,30805,71478,-40673
920649,5019,2022-06-03,4422,3936,486
225822,9903,2024-07-29,43354,91357,-48003
632027,2672,2024-08-24,28094,31024,-2930
697892,4606,2024-04-27,58420,17960,40460
387489,5336,2024-03-08,4074,75671,-71597
448611,6324,2021-12-12,21867,48921,-27054
760882,9841,2022-12-13,75260,72748,2512
985217,8442,2022-10-03,46328,15392,30936
784125,4606,2022-06-14,9760,57394,-47634
424604,6969,2023-01-22,88734,43633,45101
802540,8460,2021-10-27,23837,10764,13073
145858,8968,2022-03-16,34098,50640,-16542
955327,7680,2022-06-11,35601,13025,22576
468023,5974,2022-04-21,65727,73651,-7924
110253,1520,2024-04-07,61852,31337,30515
151091,1977,2022-11-07,78056,80842,-2786
781905,1213,2022-11-27,32636,94131,-61495
951024,8350,2022-04-19,51343,31271,20072
998708,2901,2022-01-13,73012,97517,-24505
344469,7911,2022-03-12,74163,38307,35856
760830,5382,2024-09-05,13188,59278,-46090
229655,5592,2021-09-28,13673,42377,-28704
844762,3692,2022-06-18,42094,72196,-30102
616447,4127,2023-06-17,11440,43865,-32425
674222,4676,2023-04-13,80866,57011,23855
475751,1351,2022-09-06,53559,9748,43811
180159,7132,2023-05-31,92979,6956,86023
553768,4261,2023-05-16,15560,51745,-36185
762652,2711,2022-11-19,97863,4616,93247
705824,7401,2022-05-02,21611,12379,9232
451000,1767,2023-12-11,52393,97496,-45103
402562,7443,2024-06-06,75382,73484,1898
292275,5941,2022-02-20,36333,23845,12488
258469,1103,2022-12-18,19641,99039,-79398
409517,1016,2024-03-15,38814,74660,-35846
318750,5478,2022-04-26,84825,16939,67886
404522,8130,2024-05-17,96909,13552,83357
711123,1651,2022-10-29,30746,44623,-13877
687470,1948,2022-06-03,52120,69741,-17621
422788,7120,2023-01-27,19134,84971,-65837
436322,9941,2023-03-19,2653,96112,-93459
103754,4227,2022-09-27,89366,51096,38270
426123,5575,2022-09-22,11366,58686,-47320
702388,5328,2022-07-19,30797,8973,21824
474694,5986,2023-01-13,74702,10998,63704
320997,9225,2023-12-07,99992,8502,91490
468322,6917,2024-04-06,68532,33449,35083
500328,3116,2021-10-25,53082,69432,-16350
182021,2821,2022-07-21,87179,39656,47523
725187,1016,2023-07-21,59298,47329,11969
613652,6361,2023-04-11,50713,40262,10451
351730,8030,2022-10-12,57426,8297,49129
697584,7810,2023-01-06,15445,21370,-5925
658873,8622,2022-01-17,70461,31681,38780
839179,6347,2022-01-26,72654,70334,2320
921038,6726,2023-10-27,23637,74889,-51252
914902,9116,2022-09-07,79914,32250,47664
329282,7635,2023-12-26,40549,58447,-17898
388074,1948,2024-01-07,59864,38253,21611
968736,3116,2024-07-16,18055,1578,16477
539439,5882,2023-02-19,47801,13785,34016
829653,2193,2023-12-17,78952,52304,26648
633982,9694,2024-05-21,98578,23662,74916
389655,7014,2021-10-27,51693,2695,48998
416823,4363,2022-11-23,7479,34059,-26580
789710,2355,2022-07-09,93364,17511,75853
937541,5007,2023-07-15,1000,74010,-73010
126270,1308,2022-01-12,60258,67504,-7246
666212,2355,2023-12-05,96878,10196,86682
432930,5459,2024-02-26,63951,65633,-1682
632395,6016,2022-09-12,23143,1435,21708
540929,7330,2022-02-28,14290,35802,-21512
916435,1880,2024-05-09,6440,99455,-93015
327149,2929,2022-07-08,65583,7736,57847
646222,9694,2022-11-18,99113,22222,76891
276596,7263,2024-08-03,3130,46871,-43741
874017,5126,2021-11-29,57309,60647,-3338
876097,9309,2023-08-15,56350,24188,32162
909844,9619,2022-03-15,28391,84324,-55933
590915,5126,2022-11-04,6803,2184,4619
781058,4399,2023-08-25,26664,78804,-52140
455007,2711,2024-06-02,93554,2006,91548
762339,2074,2022-04-22,9481,28829,-19348
250203,5007,2021-11-01,12823,21393,-8570
318333,9207,2022-10-27,57534,99872,-42338
527515,2672,2023-07-23,30248,22499,7749
583437,8740,2023-06-12,39591,17266,22325
131674,7263,2022-03-22,29018,16428,12590
847694,6319,2022-12-02,14044,62963,-48919
430464,4999,2022-10-20,56145,40707,15438
517511,3194,2023-01-05,39641,45303,-5662
396579,4084,2022-05-22,56302,90027,-33725
589542,4735,2021-12-25,85207,32263,52944
452785,4165,2023-01-27,45695,36231,9464
915510,2398,2023-02-02,16866,55225,-38359
479491,7810,2023-04-18,32753,33382,-629
988938,3832,2023-12-21,66165,18084,48081
937677,4224,2021-11-27,94813,35715,59098
396350,3116,2021-09-28,66916,28269,38647
154255,3051,2021-11-16,79187,15968,63219
998585,8030,2023-03-31,32134,14143,17991
506797,6371,2024-05-03,37954,1129,36825
577872,3072,2024-07-13,79805,45877,33928
641188,9223,2023-09-22,72265,52164,20101
218240,9841,2023-02-26,15620,15120,500
736072,8905,2022-01-25,16367,53793,-37426
938468,1008,2023-02-02,85756,19991,65765
101296,4735,2024-06-17,8644,66843,-58199
333356,2688,2023-03-20,50643,79047,-28404
418608,9060,2023-05-06,27445,63490,-36045
815455,6690,2022-10-21,81445,20119,61326
264441,9538,2022-09-10,30404,79145,-48741
567625,4059,2023-10-08,54358,73553,-19195
527944,7443,2022-12-04,72682,50201,22481
789445,9225,2021-10-13,82620,46020,36600
453705,3072,2024-01-02,17641,24817,-7176
732802,2972,2022-12-25,13507,93524,-80017
153694,5626,2022-05-25,99562,74455,25107
319731,9941,2022-04-18,12950,32141,-19191
475152,5770,2024-07-02,34589,16776,17813
681635,3572,2023-05-20,21386,54518,-33132
767840,9915,2022-08-30,6785,26554,-19769
928671,8662,2023-10-15,15471,23621,-8150
303706,3326,2024-01-05,11821,47479,-35658
682917,8989,2023-09-05,27107,65096,-37989
627548,1711,2023-12-05,3403,56304,-52901
377027,7454,2022-02-02,59870,51482,8388
698921,4950,2022-11-28,48616,88630,-40014
254274,4084,2024-06-07,46473,74899,-28426
983470,7917,2024-05-01,26928,8881,18047
120243,4465,2021-12-16,64426,82655,-18229
571914,2105,2024-07-25,72427,83286,-10859
157118,8357,2023-02-25,65871,17150,48721
897815,5157,2024-09-17,45561,77336,-31775
861198,9596,2021-10-12,88722,36292,52430
237824,7818,2022-12-31,33597,56734,-23137
583366,5785,2024-01-02,10345,81613,-71268
619364,8218,2022-02-14,59985,78397,-18412
738709,2711,2023-04-20,78500,47311,31189
280908,7530,2022-07-04,21505,96374,-74869
783899,1216,2023-08-06,48397,50153,-1756
392245,6371,2024-07-16,48289,33908,14381
215326,2476,2022-09-29,29702,59544,-29842
249023,6332,2024-04-13,34468,51985,-17517
934297,5126,2023-10-02,20131,8634,11497
899533,2693,2023-03-27,59473,14356,45117
210373,5894,2022-01-19,11222,27025,-15803
270240,8992,2023-04-05,44533,85093,-40560
872038,9644,2022-08-22,74235,78223,-3988
679824,3144,2023-04-10,96120,30943,65177
969147,6205,2023-07-25,5265,24921,-19656
305579,1833,2022-03-16,59652,54969,4683
682023,5785,2022-01-04,6047,85897,-79850
894144,7263,2024-04-08,79389,59411,19978
818876,1396,2022-02-01,18543,67551,-49008
207910,2450,2022-11-18,35418,65124,-29706
113854,7022,2024-07-28,45061,69065,-24004
364308,2869,2023-03-16,6445,92858,-86413
241631,2074,2024-04-05,45445,7321,38124
286763,9023,2024-01-20,85563,56993,28570
131650,9787,2021-11-12,77037,67182,9855
257763,9694,2022-12-05,86054,28459,57595
210729,4597,2023-04-14,58651,63553,-4902
275121,2251,2024-04-18,65196,46789,18407
225710,8516,2022-03-03,90968,44284,46684
517972,4811,2024-07-12,76312,98261,-21949
962045,6205,2024-09-17,92617,43291,49326
708761,5464,2023-05-22,26635,91792,-65157
144677,4399,2022-10-14,81511,50043,31468
544368,1103,2023-08-10,94813,25625,69188
156021,2868,2024-04-04,86501,84500,2001
822037,6969,2022-09-29,80304,92847,-12543
396137,7290,2024-03-11,85321,54992,30329
249749,7264,2021-12-16,62413,67900,-5487
875468,4999,2022-02-23,12799,64522,-51723
692272,2623,2023-12-27,33247,5149,28098
579069,1396,2023-05-16,40661,63855,-23194
581985,1302,2023-03-17,67924,81442,-13518
410588,8026,2024-02-10,74889,55243,19646
235868,2426,2023-04-17,54134,12126,42008
121528,4478,2022-04-02,47955,32644,15311
686081,9901,2022-10-10,81746,88229,-6483
550073,5988,2024-01-01,74472,73315,1157
887469,1767,2023-02-16,9948,57476,-47528
620471,1977,2023-06-06,26718,25617,1101
916497,3791,2024-09-15,14255,89768,-75513
911736,2821,2023-11-23,55709,31112,24597
357690,9327,2022-10-17,12694,29394,-16700
195776,1497,2023-06-15,95928,42872,53056
391942,8702,2023-04-03,86044,87406,-1362
358022,4726,2024-02-20,31165,96310,-65145
771434,8357,2024-08-01,34765,59871,-25106
829465,2733,2022-05-25,84808,97647,-12839
236345,5427,2022-02-15,12086,15350,-3264
280550,5330,2023-05-10,72347,94966,-22619
324224,5986,2023-11-26,7205,41949,-34744
371335,5484,2024-04-09,54391,96431,-42040
664771,4900,2022-03-25,77049,46654,30395
536868,2774,2023-12-31,33063,73911,-40848
505866,5478,2024-04-14,33242,75461,-42219
960865,1448,2022-07-19,4963,97156,-92193
894743,5386,2022-01-24,42177,47976,-5799
458768,2972,2022-04-08,48529,71932,-23403
187361,3015,2022-12-18,99338,7183,92155
399915,7454,2024-04-27,80178,27562,52616
896737,2640,2022-09-15,25709,68258,-42549
629475,7174,2022-03-25,63789,23663,40126
943773,2640,2023-08-22,10408,62488,-52080
166803,7670,2021-10-25,67766,16284,51482
486542,2288,2022-12-20,63920,37932,25988
787381,5071,2024-05-06,91742,35687,56055
987493,8351,2023-04-22,6822,39759,-32937
707260,3712,2021-12-29,29979,59960,-29981
242834,3319,2022-09-01,57195,31016,26179
866048,4091,2022-04-24,68087,27358,40729
688268,8218,2024-02-14,92771,51803,40968
738977,9951,2023-05-03,88915,4635,84280
938735,1103,2024-02-29,28405,66253,-37848
600430,5853,2022-01-05,38799,67813,-29014
745457,1250,2023-11-26,58191,66663,-8472
623747,5249,2023-05-01,22914,35468,-12554
872236,4002,2023-01-13,4965,96821,-91856
582598,2972,2022-05-27,6692,4768,1924
498383,3776,2022-07-19,25348,64216,-38868
624400,4811,2024-07-13,69579,72370,-2791
910132,5382,2023-10-29,85506,84879,627
864634,4717,2022-10-23,97939,19650,78289
760666,4369,2021-11-20,58299,30423,27876
387882,4272,2023-02-28,93601,40026,53575
386472,2213,2023-03-07,18771,80716,-61945
371434,5853,2021-11-29,32233,46337,-14104
776244,9719,2022-07-22,19458,41994,-22536
535477,4717,2023-11-23,89917,69623,20294
507210,7635,2022-06-21,8179,85792,-77613
583556,3559,2023-08-06,20049,37680,-17631
772578,4595,2023-06-25,26126,77401,-51275
208327,4900,2024-06-27,34687,79190,-44503
349780,3292,2022-10-28,89489,39802,49687
319132,8925,2022-04-28,2925,84178,-81253
241177,3222,2023-01-15,28878,56031,-27153
923653,9672,2022-01-27,37819,47747,-9928
532307,6361,2023-05-13,88683,51751,36932
955093,1148,2022-02-12,78200,17243,60957
507987,8989,2023-11-20,96590,36899,59691
387389,9951,2023-05-05,38025,17170,20855
237709,8026,2022-05-30,95407,44741,50666
172784,4272,2021-09-30,21293,23961,-2668
184674,9317,2022-08-19,94431,88375,6056
980785,2074,2023-12-21,25355,78816,-53461
294313,7231,2022-04-21,74139,33832,40307
778543,4532,2022-05-21,56629,84763,-28134
699557,3292,2024-04-18,29392,7771,21621
766620,4703,2024-02-17,6138,45077,-38939
337274,3450,2024-06-18,60936,64821,-3885
848240,5685,2022-10-09,87279,71391,15888
911326,9023,2024-06-09,81590,56174,25416
722173,1882,2024-08-19,61795,8421,53374
669411,4999,2022-11-17,7178,65343,-58165
783044,7223,2023-07-29,61457,99013,-37556
419888,2398,2022-01-18,1213,38048,-36835
984625,8773,2024-02-10,10628,36052,-25424
836240,5459,2022-01-23,24937,66173,-41236
955742,8460,2023-11-11,79768,3516,76252
354351,3144,2022-03-21,31806,99286,-67480
170739,5882,2022-09-15,64385,72492,-8107
597474,1341,2023-06-04,5730,62224,-56494
793881,5247,2023-11-18,71087,95800,-24713
757887,8051,2023-12-14,47050,52984,-5934
991420,4699,2022-01-21,69561,84463,-14902
368542,1947,2024-03-27,19066,33588,-14522
192330,8740,2022-10-08,90778,90152,626
719056,8970,2022-11-22,83731,3909,79822
724799,2869,2024-04-06,28451,34036,-5585
575007,1750,2022-04-26,23215,26042,-2827
696677,8110,2022-08-30,70845,39533,31312
253848,2556,2024-05-27,48913,67160,-18247
194436,4224,2024-03-15,57520,77898,-20378
348024,1520,2023-03-17,76624,63857,12767
985335,1173,2024-02-11,77208,7724,69484
738036,7810,2022-04-28,29778,5044,24734
264361,2692,2023-05-01,94376,95050,-674
957516,1977,2022-01-23,52665,65387,-12722
747157,6361,2022-06-17,74137,95405,-21268
486511,7165,2024-03-20,94127,66050,28077
565593,2450,2022-06-03,76830,70351,6479
564671,9007,2023-05-06,67750,35928,31822
133222,2355,2023-10-08,66162,22962,43200
120679,3832,2022-05-19,50454,22068,28386
296733,4107,2021-10-28,24801,89589,-64788
165249,8773,2023-08-08,83577,87091,-3514
732893,5464,2024-05-04,95937,85125,10812
798962,7942,2023-05-20,5879,89833,-83954
913910,9322,2024-01-25,98677,44184,54493
909269,9353,2023-12-19,36893,13667,23226
254808,1448,2023-11-25,50788,42258,8530
998190,8582,2023-12-19,71022,38442,32580
628326,5941,2024-09-11,38190,34268,3922
838985,4567,2022-10-08,95132,53067,42065
928827,8925,2023-10-24,49184,85217,-36033
687013,2139,2023-12-25,10311,84481,-74170
404455,2251,2024-08-17,98335,65057,33278
897906,2355,2022-06-03,40483,17054,23429
387542,5192,2023-04-07,14709,41228,-26519
832888,6318,2024-01-14,75074,51708,23366
602418,5894,2023-01-05,48950,28486,20464
778771,8976,2022-01-16,12400,34646,-22246
553473,6663,2021-11-10,77280,92774,-15494
861364,7917,2023-10-05,31332,50204,-18872
144164,5484,2023-01-21,81841,36806,45035
697314,9055,2023-01-18,21082,76573,-55491
895641,4947,2023-06-12,43556,34542,9014
392693,5464,2022-03-12,93780,61899,31881
433843,5685,2023-10-15,42706,60568,-17862
941115,8425,2024-05-10,76940,68551,8389
559815,6965,2022-01-08,13846,7561,6285
619065,5525,2022-05-07,37723,80438,-42715
468436,9060,2023-10-16,73018,41635,31383
947058,5004,2022-08-19,53056,73318,-20262
139754,1497,2024-06-03,69069,31632,37437
766760,5382,2024-09-13,8573,68343,-59770
902377,3887,2022-12-29,54497,78399,-23902
229339,3030,2023-09-17,88501,29373,59128
918080,2230,2023-04-29,30596,76639,-46043
909530,5171,2022-04-16,2305,30468,-28163
403714,8970,2023-09-07,9633,4351,5282
206806,8905,2022-05-10,69310,22176,47134
903732,6452,2021-12-10,19447,9100,10347
459094,2611,2024-01-18,97979,20539,77440
133171,4999,2022-02-17,34264,55337,-21073
966428,7008,2024-03-27,99718,43787,55931
625969,7225,2024-06-23,8762,50485,-41723
109759,3572,2023-12-11,2892,38776,-35884
791724,9435,2023-02-24,79282,22898,56384
992351,3040,2022-09-02,62874,77883,-15009
687215,1807,2021-10-25,39792,72647,-32855
381208,9007,2022-12-04,31057,30316,741
339421,2085,2023-07-01,15822,49751,-33929
798877,3264,2024-03-10,81227,18886,62341
187003,8773,2023-06-04,32291,68438,-36147
867176,4309,2023-04-06,22405,47124,-24719
298352,7510,2022-10-10,37312,78557,-41245
309114,5322,2022-08-30,55407,77056,-21649
722759,6735,2023-12-04,55982,33937,22045
446294,7290,2024-03-29,11481,43022,-31541
732305,9731,2021-11-08,54176,92009,-37833
919041,5597,2021-11-28,52441,99050,-46609
598794,5770,2024-06-09,75660,73236,2424
969784,2901,2021-11-22,23449,49841,-26392
527359,5626,2024-02-10,96127,3420,92707
779714,7014,2023-02-16,67211,96770,-29559
137883,9478,2024-08-31,11030,29658,-18628
742390,4261,2024-05-30,61142,50055,11087
295597,9327,2024-08-21,33118,87222,-54104
274458,5386,2024-07-01,84149,50742,33407
516816,5385,2022-04-23,83262,79743,3519
886002,1250,2023-01-07,40334,64295,-23961
910416,3015,2023-10-22,42664,51899,-9235
334477,8030,2023-01-21,81696,93544,-11848
869761,5953,2022-01-07,80327,62693,17634
338643,2045,2022-07-15,57835,68484,-10649
994719,3368,2021-10-25,83282,71449,11833
557610,8358,2023-06-04,51465,36301,15164
990299,6361,2024-07-24,18258,39459,-21201
456919,2579,2022-06-28,8415,49514,-41099
810030,3144,2022-01-30,32489,45073,-12584
846599,7028,2022-10-01,63492,50139,13353
857628,8166,2022-06-08,77186,31873,45313
496914,7454,2022-09-12,73148,37449,35699
925505,2693,2023-04-13,56316,39705,16611
273176,8226,2022-07-26,47364,17375,29989
244324,9903,2022-12-03,66865,94347,-27482
628266,9941,2022-07-04,84439,20661,63778
479796,9804,2023-04-21,24120,29991,-5871
887295,5007,2023-09-09,5061,86472,-81411
397989,2217,2023-07-12,68286,19107,49179
581509,2089,2023-08-07,76789,41974,34815
770569,9901,2021-10-26,35294,41350,-6056
604800,7567,2022-07-09,25674,19030,6644
538452,6149,2023-07-03,84762,89081,-4319
710033,3498,2023-06-13,72599,86935,-14336
745270,5798,2024-03-17,37198,44892,-7694
284919,9055,2023-01-17,3680,55985,-52305
741614,9951,2024-08-17,89148,16366,72782
285855,6821,2024-08-04,97264,16250,81014
949020,5180,2024-02-12,80598,16280,64318
756723,1449,2024-04-05,56794,23845,32949
702906,8999,2021-12-07,11322,27378,-16056
178486,9474,2022-05-07,4307,35661,-31354
849887,7132,2022-09-30,49260,36622,12638
438222,1869,2024-07-18,95034,71319,23715
321783,5385,2024-06-07,93308,25581,67727
196394,5966,2022-05-14,38456,99691,-61235
905511,7911,2024-08-16,86007,75165,10842
188786,7204,2023-12-24,85183,10635,74548
539131,4369,2022-12-14,92161,54701,37460
705600,6452,2024-01-13,58931,99589,-40658
480752,2330,2023-06-08,17594,1086,16508
168623,8218,2022-11-20,31188,74711,-43523
987673,7917,2022-10-06,86650,48529,38121
965059,6332,2023-03-09,35898,54646,-18748
573543,2355,2023-07-10,41594,79195,-37601
206977,1250,2023-08-16,30922,35067,-4145
720239,3411,2022-01-22,58799,78172,-19373
390379,7231,2024-05-25,14484,63071,-48587
259375,3222,2023-02-15,82829,76035,6794
269795,5157,2022-08-02,59946,17796,42150
229782,5007,2022-11-22,58671,11332,47339
344668,1016,2024-04-23,42262,83411,-41149
105591,2672,2023-11-10,14791,99974,-85183
771371,9865,2024-09-06,89119,28375,60744
797082,9841,2022-06-01,61045,58828,2217
804342,5957,2023-12-02,82145,55230,26915
213001,1504,2024-05-19,18039,69425,-51386
252209,8800,2023-05-24,6890,66524,-59634
442793,4968,2022-02-06,20130,2267,17863
648678,5808,2024-07-28,67060,75086,-8026
582838,6332,2024-06-12,40775,18165,22610
955502,5386,2024-05-07,71733,58324,13409
990101,3108,2021-11-22,87381,11727,75654
311346,1308,2022-08-05,52592,37396,15196
722744,7303,2023-09-30,1458,42572,-41114
546323,2085,2021-10-22,17852,73744,-55892
791942,4346,2023-10-29,77080,12523,64557
743378,4606,2022-05-26,63340,54778,8562
645637,9353,2024-07-10,32003,90004,-58001
279031,5157,2022-09-12,33837,69451,-35614
349438,5713,2021-10-10,16451,44481,-28030
794611,9538,2024-09-13,12584,11147,1437
625098,1376,2022-09-16,96770,32452,64318
679639,6539,2023-11-22,53278,25161,28117
320706,2672,2023-12-16,60599,23126,37473
441357,8817,2022-11-03,70485,93577,-23092
688743,6691,2022-05-01,91853,19610,72243
702159,6352,2023-07-25,88301,82699,5602
602219,2049,2023-11-18,85151,64332,20819
241940,9981,2023-07-24,92507,46742,45765
654599,5386,2022-01-08,65938,59509,6429
711310,9012,2022-10-17,79606,31425,48181
806091,9470,2023-10-12,90417,96064,-5647
500571,4689,2021-12-14,58620,7235,51385
739451,5974,2023-06-14,92829,94252,-1423
704578,4947,2022-10-16,56700,95937,-39237
369994,1479,2022-10-10,64004,23265,40739
832635,1213,2024-03-05,64376,64498,-122
644229,8218,2023-08-16,66462,25231,41231
637230,1227,2024-01-19,97821,66496,31325
240568,5478,2022-02-24,80819,64672,16147
569451,9207,2021-10-01,74046,43692,30354
333905,3593,2021-10-24,18322,22711,-4389
335648,2194,2024-08-25,85962,58810,27152
266396,1504,2024-09-16,34920,47910,-12990
128097,8218,2023-03-07,45016,65158,-20142
925106,4811,2022-09-20,26946,53740,-26794
822577,4100,2024-04-04,92286,54716,37570
183059,5941,2024-08-24,3101,42190,-39089
269263,7670,2023-12-14,24232,41642,-17410
508070,1537,2024-01-02,67038,18162,48876
579966,2857,2023-10-29,15333,79214,-63881
562035,6290,2023-01-18,3830,95064,-91234
305848,9915,2022-10-26,18421,29489,-11068
422420,5007,2023-01-09,26480,35892,-9412
875929,4243,2022-02-07,82241,34177,48064
494529,2398,2023-03-08,17437,37908,-20471
553663,9713,2022-10-29,88090,51837,36253
563069,6726,2022-01-04,90446,73735,16711
937322,9353,2022-01-12,47863,64031,-16168
236924,1148,2022-02-04,70496,90522,-20026
398030,7239,2022-09-24,11715,61731,-50016
265246,8351,2024-02-19,74671,77472,-2801
640054,7095,2022-12-18,62441,61509,932
137219,9012,2021-11-02,45339,70509,-25170
803179,1479,2022-07-09,77619,57119,20500
124985,7470,2022-11-27,70939,10380,60559
797898,5192,2022-11-24,63427,10943,52484
527331,7670,2023-06-06,80664,62119,18545
199722,1103,2024-09-22,48249,48768,-519
222439,1227,2022-02-12,43025,12627,30398
914456,3267,2022-09-26,2205,31233,-29028
348443,1250,2024-02-10,96517,64355,32162
595625,8319,2022-06-20,20322,17222,3100
599820,8350,2023-08-17,68245,99238,-30993
384641,9901,2024-01-22,10567,91395,-80828
276727,3891,2022-03-30,2634,96671,-94037
219451,8740,2022-06-03,3792,2806,986
719816,1104,2024-02-20,17070,9505,7565
402281,2982,2023-09-22,49422,80383,-30961
213085,8999,2024-07-01,62423,24698,37725
248617,1216,2021-11-03,26398,6607,19791
574622,6969,2022-01-09,40160,93375,-53215
543927,5604,2022-11-03,17862,80682,-62820
529552,5817,2022-08-11,13547,60178,-46631
746638,2672,2024-02-17,58813,46324,12489
545737,2251,2024-04-19,23953,87348,-63395
979549,2688,2023-09-26,42524,31001,11523
348011,4896,2022-04-03,64477,86107,-21630
341743,9538,2022-04-30,61266,39000,22266
893970,1016,2023-03-09,74891,19783,55108
197301,3144,2023-03-25,15431,56823,-41392
234429,9865,2022-04-08,51032,63881,-12849
901959,4726,2022-02-19,28676,66288,-37612
485940,5249,2021-12-19,43403,32855,10548
660604,7231,2023-04-13,75686,60066,15620
532008,4532,2024-08-29,8132,86182,-78050
945217,8138,2022-09-29,56357,77976,-21619
497413,8622,2022-06-14,80838,54134,26704
640017,7120,2022-09-05,28101,59073,-30972
677407,9901,2024-02-02,65694,75848,-10154
813003,4091,2021-12-02,76390,83657,-7267
779236,5770,2024-08-24,64594,35814,28780
807069,5004,2022-10-09,54815,16770,38045
219048,7165,2023-05-10,18968,53743,-34775
147623,5632,2023-11-04,43267,87248,-43981
952588,9116,2024-05-14,29783,72089,-42306
451865,1060,2022-07-14,44226,27496,16730
234485,7264,2023-06-07,49705,48173,1532
255008,4084,2024-02-11,42268,68091,-25823
575560,3040,2022-09-01,87444,36920,50524
147012,6726,2021-12-21,9802,64653,-54851
434335,8267,2024-03-15,15927,97510,-81583
652391,3267,2023-07-07,42993,86911,-43918
963302,1216,2024-04-01,43717,61151,-17434
832550,8442,2024-04-01,68064,42766,25298
136632,1902,2024-02-29,60377,73497,-13120
800839,8987,2024-04-24,26173,9568,16605
638359,2733,2023-01-20,68568,58570,9998
254807,7635,2024-05-29,65179,51744,13435
347246,9010,2023-05-31,91145,26250,64895
943609,2089,2022-12-29,39675,36250,3425
357174,4198,2022-04-01,40559,51437,-10878
267145,1396,2022-08-22,2050,20841,-18791
892334,5171,2022-03-10,8542,98142,-89600
702597,5004,2023-08-21,49938,67934,-17996
456762,9818,2023-01-27,72057,80933,-8876
353438,9787,2021-11-17,64871,79352,-14481
837593,5814,2024-03-10,53257,96962,-43705
448203,6115,2023-08-11,27847,72612,-44765
726695,9865,2022-06-23,20605,22950,-2345
239075,3116,2023-04-27,26560,6848,19712
323015,2089,2023-10-05,76270,46727,29543
131626,3023,2021-10-03,48883,10382,38501
469441,1351,2024-06-27,24195,66326,-42131
404017,8576,2021-11-24,92523,91087,1436
917267,7942,2024-08-12,93600,66990,26610
206576,8622,2023-09-17,41737,91516,-49779
818316,1537,2024-01-28,4173,28338,-24165
375748,2426,2023-02-08,30956,85189,-54233
496799,7530,2022-02-04,18740,11675,7065
319536,7443,2022-02-07,43308,36984,6324
350662,4241,2022-06-15,92553,25300,67253
439219,8442,2024-05-27,72181,28448,43733
151384,2929,2021-10-12,63480,47486,15994
620273,2693,2023-10-08,61701,52783,8918
486818,9207,2022-05-23,50082,10139,39943
974284,8267,2022-07-02,33194,24191,9003
868945,9672,2022-04-03,4111,9996,-5885
541008,9787,2023-11-12,24016,58384,-34368
255634,8051,2022-10-02,71728,78819,-7091
288027,9441,2022-03-19,96929,51908,45021
634881,5990,2021-10-13,5242,38782,-33540
479193,9672,2023-06-17,35978,69185,-33207
647940,9672,2023-11-20,24126,6740,17386
206733,4091,2023-05-05,59579,57762,1817
784838,2940,2022-04-11,39160,69065,-29905
821414,2991,2024-06-17,2839,2532,307
150601,8860,2022-07-01,91911,74354,17557
638722,1016,2021-11-02,78606,29887,48719
734610,2869,2024-02-26,56092,87804,-31712
475219,9672,2023-03-15,10266,69016,-58750
297254,3050,2022-02-27,7234,69158,-61924
217412,1711,2024-01-20,34387,25748,8639
345652,7166,2022-06-12,7778,78901,-71123
496412,9943,2021-10-15,85019,38837,46182
130666,2139,2022-04-23,14115,83669,-69554
245590,5798,2022-02-06,50573,25993,24580
203027,9694,2024-09-03,23482,24380,-898
